.......#.......#.....#.....#.....#.....#.......#.........#.......#.......#.#.......#...#.....#....G
.#####.#.#####.#.###.#.#.#.#.###.#.#.#.###.###.#.#######.#.###.#.#.#####.#.#.###.#.#.#.#.###.###.#.
...#.#.#.#...#.#...#...#.#.#...#...#.#...#...#...#.....#.#.#.#.#...#.#...#...#...#...#...#.#.....#.
##.#.#.#.#.#.#.#####.###.#####.#####.###.###.#######.#.#.#.#.#.#####.#.###.###.###########.#######.
...#...#...#.#.....#...#.#.....#.....#.#.#.#...#...#.#.#.....#...#...#.#...#...#.....#.....#...#...
.###.#######.#####.#####.#.#####.#####.#.#.###.#.#.#.#.#########.#.###.#.###.###.#.###.#.###.#.#.##
.#.......#...#...#.#.....#...#.#.#.......#...#.#.#...#.#.#.......#.#...#...#...#.#.#...#.....#.....
.#######.#.###.#.#.#.#######.#.#.###.#####.#.#.#.#####.#.#.#######.#.#####.###.#.###.##############
...#...#.#.#...#...#.......#...#...#.#.....#.#...#.......#.#.......#.....#...#.#...#...#...........
.#.#.#.#.#.###.#####.#####.#.#####.#.#####.#####.#########.#.###.#.#####.#####.###.#.###.#########.
.#.#.#.#.#...#.#.....#...#...#.....#...#...#.....#...#.....#.#...#.....#.....#...#...#.....#.....#.
##.#.###.#.#.#.#######.#.#.###.#######.#.###.#####.#.#.#####.#.###.#########.###.#####.#####.###.#.
...#.#...#.#.#.......#.#.#.#...#.......#.....#.....#...#.....#...#.#.........#...#.....#.....#.#.#.
.###.#.###.#.#######.#.#.#.#.#########.#.#####.#########.#######.###.#########.#.#.#####.#####.#.#.
.#...#...#.#...#.#...#.#.#.#.........#.#.....#.......#...#.....#...........#...#.#.#...#...#...#.#.
.###.###.#.###.#.#.###.#.#########.#.#.#####.#######.#####.###.###########.#.###.#.###.###.#.###.#.
...#...#.#...#.#.#.....#.........#.#.#.....#.#.....#.........#.......#.#...#.#...#...#...#.#.....#.
.#.###.#.#####.#.###############.###.#####.#.#.###.#####.###########.#.#.###.#.#####.#.###.#.#####.
.#.#...#...#...#.#.......#.#.....#...#.....#.#...#.....#...#.......#.#.......#.....#...#...#.#...#.
.#.#.#####.#.###.#.###.#.#.#.#####.#####.#######.#####.###.#.#####.#.#########.#######.#.###.#.#.#.
.#.#.......#.#...#...#.#...#.#.........#.......#...#.#...#.#...#.#.#.#.....#...#.....#.#.#...#.#.#.
##.#.#######.#.#####.#.###.#.#.#######.#######.###.#.###.#.###.#.#.#.#.###.#####.#.#.#.#.#.###.#.#.
...#...#.....#.#.....#...#.#.#...#.....#.......#...#.....#.#...#...#.....#.......#.#.#.#.#.....#...
.#####.###.###.#.#######.#.#.#####.#####.#######.###.#######.###.###########.#####.###.#.#.########
...#.....#...#...#.....#.#.#...#...#.#...#.#.....#.#...#.....#.#...........#...#.#.....#.#.#...#...
##.#####.###.#.###.###.#.#####.#.###.#.###.#.#.###.###.###.###.###########.###.#.#######.###.#.#.#.
...#...#.#...#...#...#.#.....#.#...#...#.....#.#.....#.#...#.......#.....#...#...#.....#.....#.#.#.
.###.#.#.#.#####.#.###.#####.#.#.#.#.###.#####.###.#.#.#.###.#######.###.###.###.#####.#######.#.#.
...#.#.#...#.....#.#...#...#.#.#.#.#.#.#...#...#...#.#.#.#...........#.....#.#.#.........#.#...#.#.
.#.#.#.#####.#####.#.###.#.#.#.###.#.#.#.###.###.###.#.#.#.###########.#####.#.#########.#.#.###.#.
.#...#.....#.#.....#.#...#...#.....#.#...#...#...#...#...#.#...#...#...#.....#.........#...#.....#.
.#########.###.#####.#.#.###########.#####.###.###.#######.#.#.###.#.#.#.#####.###.#####.#########.
.#.......#.#...#...#.#.#.#.........#...#...#.#...#...#...#...#.....#.#.#.#.#.....#...#...#.........
.#.###.###.#.###.###.#.###.#####.#.###.#.###.#.#.###.###.#.#####.###.###.#.#.#######.#.###.#######.
.#...#.#...#...#.#...#...#...#...#...#...#...#.#.#.#.#...#.#...#.#...#...#.....#...#...#...#.....#.
.###.#.#.#.###.#.#.#####.#.###.#####.#####.#.#.#.#.#.#.###.#.#.#.#.###.###.#####.#.#####.#####.#.#.
.#...#.#.#.#.....#.....#...#...#.....#...#.#...#.#.#.#.....#.#.#.#.#...#...#.....#.#.....#.....#.#.
.#.#####.###.#########.###.#.###.#######.#.#####.#.#.#######.#.###.#.###.###.#####.#.#####.#######.
...#...#.....#.......#...#.#.#.....#.....#...#...#...#...#...#.....#.#...#.#...#...#.....#.......#.
##.#.#.#######.#####.###.#.#.#####.#.#####.###.###.###.#.#.#########.#.###.###.#.#####.#.#.#####.#.
...#.#.........#...#.#...#.#.....#.#.......#...#...#...#.#.......#...#...#...#.#.....#.#.#.#.....#.
.###.#######.###.#.#.#.###.#####.#.#######.#.###.###.###.#.#####.#.#####.#.###.#####.###.###.#####.
.#.#.#...#...#...#.#.#...#.#.....#...#...#.#.#.......#.#.#.#...#.#.#.#...#...#...#.#...#...#.....#.
.#.#.#.#.#####.###.#.###.#.#.#######.#.#.###.#########.#.#.#.#.#.#.#.#.#####.###.#.###.###.#####.#.
...#...#.#.....#...#.....#.#.#...#...#.#...#.....#...#...#.#.#...#.#.........#...#...#...#.....#...
##.#####.#.#####.#########.#.#.###.###.###.#####.###.#.###.#.###.#.#######.###.###.#.###.#####.#.##
...#...#...#...#.#.......#.#.#.....#.....#.......#...#.#...#.#...#.#...#.#.#...#.#.#...#.#.....#...
####.#.#.###.#.#.#.#####.###.#.#########.#########.###.#####.#.###.#.#.#.#.#.###.#.###.#.#.#######.
.....#.#.#.#.#...#.....#.....#...........#.#.....#...........#...#...#.#...#...#...#...#.#...#...#.
.#####.#.#.#.#####.###.###################.#.#.###.###########.#######.#######.#.###.#.#.###.#.###.
...#.#.#...#.#.......#.#...#...#.....#...#...#.......#.....#...#.....#.......#.#...#.#.#.....#.#...
.#.#.#.#####.#.#######.#.#.#.#.#.###.#.#.#.###########.###.#####.###.#######.#.#####.#.#######.#.##
.#.#.........#.....#...#.#...#.#.#.#...#.#...#.....#...#.#.......#.#.......#...#.....#.......#...#.
.#.#############.###.#####.###.#.#.#####.###.#####.#.###.#########.#.#####.#####.#############.###.
.#.....#.......#.#...#...#...#.#.#.....#...#...#...#.#.............#.#...#.#...#...#...........#...
.#####.#.#####.#.#.###.#.#####.#.###.#####.###.#.###.#.#.#####.#####.###.#.#.#.#.#.#.###########.##
.#.....#.#...#.#.#.....#...#...#...#.....#.#.....#...#.#.....#.#.....#...#.#.#...#...#.#.......#...
##.###.#.###.#.#.#########.#.#####.#.#.#.#.#.#####.#########.#.#.#####.###.#.#########.#.#.###.###.
...#.#.#.....#.#.....#...#.#.......#.#.#.#...#...#.........#.#.#.#.#.....#.#.#.#.........#...#.....
.###.#.#####.#.#####.#.###.#.#########.#.#####.#.#########.#.#.#.#.#.###.#.#.#.#.###########.#####.
...#...#.....#.....#.#.#...#...#.......#.#...#.#.....#...#...#.#.#...#...#.#.#.#.#...#...#...#.....
.#.###.#.#########.#.#.#.#####.#.#######.###.#.#####.#.#.#####.#.###.#.###.#.#.#.#.#.###.#.########
.#...#.#...#.....#.#...#.....#...#...#...#...#.#...#.#.#.......#...#.#.....#.#.....#...#.#.........
.###.#.###.#####.#.#########.###.#.#.###.#.###.###.#.#.###########.#.#######.#########.#.#####.###.
.#.#.#.#...#.....#...#.......#...#.#...#...#...#...#.......#...#...#.#.....#.#.......#...#...#.#...
.#.#.###.###.###.###.#.#.#########.###.#####.###.###########.#.#.###.###.#.#.#.#####.###.#.#.###.#.
.#.#...#.#.....#.#...#.#.#...#.....#.#.....#.#...#...#.....#.#...#...#...#.#...#...#...#.#.#.....#.
.#.###.#.#####.###.###.###.#.#.#####.#####.#.#.#.#.#.#.###.#.#####.###.###.#####.#.###.#.#.#######.
.#...#.#.#.....#...#.......#...#.....#...#...#.#...#.#...#.#...#.#.#...#.#.#.....#...#.#.#.....#.#.
.#.###.#.#.###.#.###.#############.#.#.#######.#####.###.#.###.#.#.#.###.#.#.###.###.#.###.###.#.#.
...#...#...#...#.#.#.#...#.........#.#.......#.#...#...#.#.....#.#...#.#...#...#.#...#...#.#...#...
####.###.#####.#.#.#.#.#.#####.#####.###.###.#.#.###.#.#.#######.#####.#.#######.#######.#.#.###.##
.....#...#...#.#.#.#...#.....#...#.....#.#...#...#...#.#.#...#.........#.........#.......#.#...#.#.
.###.#.###.#.###.#.#########.#.#.#####.#.#######.#.###.#.#.#.#####.###.#####.#####.###########.#.#.
...#.#.#.#.#.#...#.#.......#.#.#.....#...#.....#.#...#.#.#.#.....#.#.......#.#.....#...........#.#.
.#.###.#.#.#.#.###.#.#.###.#.#.#####.#####.###.#.###.###.#.#####.###.#####.#.#.#####.###########.#.
.#...#...#.#.#.#...#.#...#.#.#.#...#.#.....#...#.#...#...#.....#.....#.....#.#.....#.......#.......
.###.###.#.#.#.#.#.#.###.#.#.#.#.#.#.#.#####.###.#.###.###.###.###.#######.#.#####.#.#####.########
...#...#.#.#...#.#.#...#.#.#.#.#.#...#.#.#...#...#.#...#.....#.#...#.....#.#...#...#.....#.#.......
##.###.#.#.#####.#####.#.###.###.###.#.#.#.#.#.###.#.#########.#.###.###.#.###.#.#######.#.#.#####.
.#...#...#.#...#.....#.#.....#...#...#.#.#.#.#.#.#.#.....#.....#.#...#...#.#...#...#.....#.......#.
.#.#######.#.###.###.#.#######.#.#####.#.#.###.#.#.#####.#.#####.#.###.#####.#####.###############.
.#.#.......#.....#.#...#.....#.#.#...#...#.#.....#...#.#.#...#...#...#...........#.........#...#...
.#.#.#######.#####.#####.###.#.###.#.###.#.#.#####.#.#.#.#.#.#.###.#######################.#.#.#.##
...#.#...#...#.#.........#...#...#.#.....#...#.....#...#.#.#.#...#.#.....#.........#.......#.#.#...
####.#.###.###.#.#####.###.#####.#.#######.###.#######.#.#.#.#####.#.###.#.#######.#.#######.#.###.
.....#.....#.....#...#.#...#.....#...#...#.#...#.#.....#.#.#.#.....#.#.#...#.#.....#.#.......#.....
.#####.#####.#####.#.#.###.#.###.###.#.#.###.###.#.#####.###.#.#####.#.#####.#.#####.#.############
.#.#...#...#...#...#.#...#.#.#...#...#.#...#.#.#...#...#...#.......#.#.......#.......#.#...#.......
.#.#.###.#.###.#.###.###.#.#.#####.###.###.#.#.#.###.#.###.#########.###.###.#########.#.#.#.#####.
.#.#.#...#...#...#...#...#.#.......#...#.#...#...#...#...#.........#.....#.#...#.....#...#.....#...
.#.#.#.#####.#####.###.###.#########.###.#####.#########.#########.#######.###.#.###.#####.#####.#.
.#.#...#.#...#.......#...#.#.........#...#...#.#.......#.#.......#...........#.#.#.#.....#.#...#.#.
.#.#####.#.###.#########.#.#.#########.#.#.#.#.#.#.###.#.#.###.#########.###.#.#.#.#####.###.#.#.##
.#.......#.#.......#.....#...#.#.......#.#.#...#.#.#...#.....#.........#.#...#...#.....#.....#.#...
.#.#######.#########.#########.#.#.###.###.#######.#.#############.###.#.#########.###########.###.
.#.......#.........#.#.....#.....#...#.#...#.......#.........#...#...#.#...#.....#...#.......#.#...
.#.#####.#########.#.#.###.#.#######.###.#####.#############.#.#.#####.###.#.###.#.#.#.#.#####.#.#.
S#.....#.............#...#.........#...........#...............#.........#.....#...#...#.........#.