...#...............#...........#.....#.......#.................#.......#.........#.........#......G
##.#.#.###########.#.#.#####.###.###.#.#.#####.#######.#######.#.#.#####.#.#######.###.###.#####.#.
...#.#.....#.....#.#.#...#.#.#...#...#.#...#...#.....#...#.....#.#...#...#.........#.#.#.#...#...#.
.#########.#.###.#.#.###.#.#.#.###.#.#.###.#.#####.#.###.#.#####.###.#.#####.#####.#.#.#.###.#.####
.........#.#.#.#...#...#.#...#.#...#.#...#.#.....#.#...#.#.....#.#.#...#...#.#...#...#.#.....#.....
########.#.#.#.#######.#.#####.#.###.###.#.#####.#####.#.#######.#.#####.#.###.#.#####.#.#########.
.........#.#...#...#...#...#...#...#.#...#.....#.......#.........#.....#.#.....#.......#.#.....#...
.#########.###.#.###.#####.#.#####.#.#.#######.#######.###############.#.###############.#.###.#.##
.#.......#.#...#...#.#...#...#.....#.#.....#...#.....#...#.#...#.......#...............#...#.#.#...
.###.###.#.#.###.#.#.#.#.#####.#########.###.###.###.###.#.#.#.#.#.###################.#####.#.###.
.....#...#.#.#.#.#...#.#...#...#.........#...#...#.#...#.#...#...#.#.........#.......#...#...#...#.
######.###.#.#.#.#####.#.###.###.#########.#.#.###.###.#.#.#######.#.###.###.#######.###.###.###.#.
.#...#.....#.#.#...#...#...#...#.#.....#...#.#...#...#.#.#...#...#...#...#.#.......#...#...#...#.#.
.#.#.#######.#.###.###.###.###.#.#.###.#.#######.#.###.#.###.#.#.#####.###.#######.#.#####.#.#.#.#.
.#.#.....#...#.......#...#...#...#.#...#...#...#.#...#.#...#.#.#...#...#.........#.#.#.....#.#...#.
.#.#####.#.#########.#####.#.#####.#.#####.#.#.#.###.#.###.#.#.###.#.###.#########.#.#.#####.#####.
.#.#...#.#.#.......#.......#.#.....#...#.#...#.#.....#.....#...#.#.#...#.#.........#.#.....#.#.....
.#.#.#.#.#.#.#####.#########.#.#######.#.#####.#####.###########.#.###.#.#.#########.#####.#.#.###.
...#.#...#...#...#...#.....#.#.....#...#.....#.....#.#.......#.......#.#...#...#.......#.#.#...#...
.###.#########.#.###.###.#.#.#.###.#.#######.###.#.#.#.#####.#.#######.#.#####.#.###.#.#.#.#######.
.#.#.........#.#...#...#.#...#.#...#...........#.#.#.#.....#...#.#.....#.....#...#...#...#.#.....#.
.#.#####.#####.###.###.#####.###.#############.#.#.#.#####.#####.#.#########.#####.#####.#.#.###.#.
.#.....#.....#...#...#.....#...#.#.......#.#...#.#.#...#.#...#...#.#.......#.......#...#.#...#.#.#.
.#.###.#####.###.#.#.#####.###.#.#.###.#.#.#.###.#####.#.###.#.#.#.#.#####.#########.#.#.#####.#.#.
...#.#.#...#.....#.#.#.....#.#...#...#.#...#.#.#.....#.#.#...#.#.#.#.#.......#.......#.#.#.....#.#.
####.#.###.#######.#.#.#####.#########.###.#.#.#####.#.#.#.###.###.#.#######.#.#######.#.#####.#.#.
.....#.#...#.......#.#...#...#.........#...#...#...#...#.......#...#.......#...#.....#.#.......#.#.
##.###.#.#.#.###########.#.###.###.#.#####.###.#.#.###########.#.#######.#.###.#.###.#.#####.###.#.
...#...#.#.#.#.........#.#.....#...#.#...#...#...#.#.....#...#.#...#...#.#...#.#.#.#.#.#.....#...#.
.#.#.###.#.#.#.#######.#.#######.#####.#.#.#######.###.#.#.#.#.###.#.#.#.###.#.#.#.#.#.#####.#.###.
.#.#.....#.#.....#.....#.......#.....#.#.#.#...........#.#.#.#.#...#.#.#.#...#.#.#.#.#.....#.#...#.
.###.#############.###########.###.#.#.#.###.###########.#.#.###.###.#.###.###.#.#.#.#####.#####.#.
.....#.........#...#.....#...#...#.#...#.........#.....#...#...#...#.#.....#...#...#.....#.#...#.#.
.#####.#######.#.#.#.#.###.#.###.#######.#########.###.#######.###.#.#############.#####.#.#.#.#.##
.#...#.......#...#.#.#.#...#...#.......#.#.......#...#.#...#...#...#.................#...#...#.#...
.###.#######.#.#####.#.#.#####.#######.#.#.#####.###.#.###.#.###.#.#################.#.#######.###.
.#.......#...#.#...#.#...#...#.#.......#.#.#...#.....#...#...#...#.#.........#.#...#.#.#...#.......
.#.#####.#.#####.#.#.#####.#.#.#.#########.#.###########.#.###.###.#######.#.#.#.#.###.#.#.#######.
.#...#...#.......#.#...#...#...#...#.......#.#.......#...#.....#.#.....#...#...#.#.....#.#...#.#...
.#.#.#.###########.#.###.#########.#####.###.#.#.###.#.#########.#####.#.#####.#.#######.###.#.#.##
.#.#.#.#...#.....#...#...#.........#...#.#...#.#...#.#.#.....#...........#...#.#.......#.#...#.....
.#.#.#.#.#.#.###.#####.###.#########.#.#.#.#.#.###.###.#.###.#.#############.#.#######.#.#.#######.
.#.#.#.#.#...#.#.....#...#...#.....#.#...#.#...#.#...#...#...#.#.#.........#.......#...#.#.......#.
.###.#.###.###.#.###.###.###.#.###.#.#####.#####.###.#####.###.#.#.#######.#########.#.#.#######.#.
.#...#...#...#.#...#.#.....#.#...#...#.........#...#...#...#.#...#.#.......#.........#.#.#.#...#.#.
.#.#####.###.#.###.#.#.###.#.###.#.###########.#.###.###.###.###.#.#.#######.#########.#.#.#.#.#.##
.#.#...#...#.....#.#.#.#...#.#...#.#.....#.#...#...#.....#.....#.#.#.....#.....#.....#.#.#...#.#...
.#.#.#####.#######.###.#.###.#.#####.###.#.#.#####.#######.#.###.#.#####.#####.#.#####.#.#.###.###.
...#.....#.#.....#.#...#.#...#.#.......#.#.#.#.....#.......#.....#.#.....#.....#.#...#.#.#.#.....#.
####.#.###.#.###.#.#.###.#.###.#.#######.#.#.#.###.#######.#######.#.#####.#####.#.#.#.#.###.###.#.
...#.#...#.#.#.....#.#...#.#...#.#...#...#...#...#.......#.......#.#.#.......#.....#.#.#.....#...#.
.###.###.#.#.#.#####.#.###.#.###.#.###.#####.###.#######.#######.#.#.###.###.###.###.#.#######.###.
.....#.#...#.#.#.#...#.#...#...#.#...#.#...#...#.......#.......#.#.#...#...#...#...#...#.#.......#.
.#####.#####.#.#.#.#####.#####.#.###.#.#.#.###.#.#####.#######.###.###.###.###.#.#####.#.#.#######.
.#.....#.....#.#.#.......#...#.#...#.#...#.#.#.#.#...#.....#.......#...#...#...#.#...#.#.#.#...#...
.###.###.###.#.#.#########.#.#.###.#.#####.#.#.#.#.#####.#.#########.#######.#####.#.#.#.#.#.#.#.##
.#...#...#...#.#...#...#...#.....#.#.#.....#.#.#.#.#...#.#.#.......#.......#.......#.#...#...#.#...
.#.###.###.###.#.#.###.#.#.#####.#.#.#.#####.#.#.#.#.#.#.#.#.#####.#######.#######.#.#########.###.
.#.....#...#.#...#...#...#...#...#...#.#.#.....#...#.#.#.#...#...#.#.....#.......#.#...#.........#.
.#######.###.#######.###.###.#.###.###.#.#.#########.#.#.#######.#.###.#########.#.###.#.#########.
.#.......#...#.....#...#...#.#.#...#...#.......#.....#.#.........#...#.........#.#...#...#.....#...
.#.#######.#.#.###.###.#.###.#.#.###.#.#######.#.#####.#########.###.#########.#.###.#####.#.###.#.
...#.......#.#...#...#.#.#...#.#...#.#.#...#.#...#...#.........#...#.#.......#.#...#...#...#.#...#.
####.#######.###.#.###.#.#.###.###.#.#.#.#.#.#####.#.#.#######.#####.#.#####.#.###.###.#####.#.###.
...#.....#.#...#.#.....#.#.#.....#.#.#.#.#.#.....#.#...#.....#.#.....#.#.......#...#.........#.#...
.#######.#.###.#.#########.#.#####.#.###.#.###.###.#####.###.#.#.#####.#######.#.#############.#.##
.......#.#...#.#.#.......#.#.#.....#.#...#...#.....#.#...#.#.#...#.#.........#.#.#...........#.#.#.
.#.#####.#.###.#.###.###.#.###.#####.#.#####.###.###.#.###.#.#####.#.#######.###.#.#.#######.#.#.#.
.#...#.....#...#.....#...#.....#...#.....#.#...#.....#.....#.#...#.#.#.....#.....#.#.....#.#...#...
.###.#.#####.#########.#######.###.#####.#.###.#####.#####.#.#.#.#.#.###.#.#######.#####.#.#######.
.#...#...#...#.......#.......#.....#...#...#...#...#.#.....#.#.#.#.......#.#...#.#.....#.#.....#...
##.#.###.#.###.#####.#######.#######.#.###.#.#.#.#.#.#.#####.#.#.#########.#.#.#.#####.#.#.#####.##
...#.#.#.#.....#...#.......#.#...#...#.#.#.#.#.#.#.#.#.#...#...#.#.....#.....#.#.#.....#.#.....#...
.###.#.#.#######.#.#####.#.#.#.#.#.###.#.#.#.#.#.#.#.#.#.#######.#.###.#######.#.#.#####.#.###.###.
.#.#.#.#.......#.#...#...#.#...#...#.#.#...#.#.#.#.#.#.#.....#...#.#.#.....#...#...#...#.#...#.....
.#.#.#.#######.#.#.###.###.#########.#.###.#.###.#.###.#####.#.###.#.#####.###.#.#####.#.###.######
.#...#.......#...#.#...#.#...#...#...#...#.#.....#...#.....#.#...........#...#.#...#...#...#.......
.#.#####.#####.#####.###.###.#.#.#.#.###.#####.#####.#####.#.###############.#.###.#.#.###.#######.
.#.......#.....#.....#.....#.#.#.#.#.#.#.....#.....#.#...#...#.............#.#...#...#...#.#.#.....
.#########.#####.#####.###.#.#.#.#.#.#.#####.#####.#.#.#.#.###.###########.#.###.#########.#.#.####
...#.........#.#...#...#.#...#.#.#.#...#...#.#...#.#...#...#...#.#.......#.#.#.#...........#.....#.
##.#.#######.#.###.#.###.#####.#.#.###.###.#.#.###.#########.###.#.#.#.###.#.#.###.#############.#.
...#.#...#...#...#.#.#.....#...#...#...#...#.#.....#.#...#...#...#.#.#.#...#.#.....#.....#...#.#.#.
.###.#.#.#.###.###.#.#.###.#.#########.#.#.#.#.#####.#.#.#.###.#.#.#.#.#.###.#.#####.###.#.#.#.#.#.
.....#.#.#.....#...#...#.#.#.........#.#.#.#.#.......#.#...#...#...#.#.#.#...#.#...#...#...#.#.#...
.#####.#.#######.#######.#.#.#######.#.#.#.#.#########.#######.#####.###.#.#.###.#.###.#####.#.###.
.#.#...#.........#.#.......#...#.....#...#.#.#...#.....#.....#.#.....#...#.#...#.#.....#...#.#.....
.#.#.#############.#.###########.#######.###.#.#.#.#####.###.###.#####.#####.#.#.#####.#.#.#.#.####
...#.......#.......#.#.......#...#...#...#...#.#.#.....#.#...#...#...#.....#.#...#...#...#.#.#.....
##.#######.#.###.###.#####.#.#.#.#.#.###.#.###.#.#####.#.#.###.###.#.#####.#.#####.#.#####.#.#####.
.....#.....#...#...#.#.....#...#.#.#...#.#.#...#.#...#.#.#.....#...#.....#.#.....#.#...#...#.#.....
.#####.###########.#.#.#######.###.###.#.#.#.###.#.#.#.#.#######.###.#.###.###.###.###.#.###.#####.
.#...#...#...#...#.#...#.......#...#.#.#.#...#.#...#.#.#...........#.#.#...#.#.#...#.#.#...#.....#.
.#.#.###.#.#.#.#.#.#.###########.###.#.#######.#####.#.#######.#####.###.###.#.#.###.#.#########.#.
.#.#.....#.#...#.#...#...........#...#.....#.........#.......#.#...#...#.#.....#.#...#.....#.....#.
.#.###.###.#####.#####.###########.#.###.###.###############.###.#.###.#.#.#####.#.#.#####.#.#####.
.#.#...#...#.#...#...#...#.......#.#...#...#...#...#.....#...#...#.....#.#.....#.#.#.....#.#.#...#.
.#.#####.###.#.###.#.###.#.#####.#.###.###.###.#.#.#.###.#.###.#########.#######.#.#####.#.#.#.###.
S#...........#.....#.......#.......#.....#.......#...#.....#.....................#.....#.....#.....