...#.......#.......#...#...........#.#.......#.................#.......#...........#...........#..G
##.#.#.###.#.###.#.#.#.#######.###.#.#.#.#####.###########.###.#.###.#.###.#######.#####.#####.#.#.
...#.#.#...#.#...#...#.........#.#.#.#.#...#...#...........#.#.#.#...#...#...#...#.....#.#...#...#.
.#####.#.#####.#################.#.#.#.###.#.###.###########.#.#.#.#####.###.#.#.#####.#.#.#.#####.
.......#.....#.......#.......#...#...#...#...#.#...#...#...#.#.#.#.....#.....#.#.#.....#...#...#.#.
############.#.#####.#.#####.#.#.###.###.#####.###.#.#.#.#.#.#.#.#####.#########.#.#########.#.#.#.
...#.......#.#...#.#...#...#.#.#.......#.........#...#.#.#...#.#.#...#.#.........#.#.#.....#.#.#.#.
.#.#.#####.#.###.#.#####.#.#.#.###########.###########.#.###.#.###.#.#.#.#######.#.#.#.#.#.#.#.#.#.
.#.#.#...#...#.#.........#.#.#.#...........#.....#...#.#.#...#.....#...#...#.....#.#...#.#.#.#.#...
.###.#.#.#####.###########.#.###.###########.###.#.#.#.#.#################.#.#####.#####.#.#.#.#.##
...#.#.#.....#.......#...#.#...#...#.#.......#.....#...#.#.........#.......#...#.#.......#.#.#.#...
##.#.#.#####.#.#.###.###.#.###.###.#.#.#.###############.#.###.#####.#.#######.#.#########.#.#.####
...#.#.#.....#.#.#.......#.#.#...#.#.#.#.#.......#.....#.....#...#...#.....#.......#.......#.#.#...
.#.#.#.#.#######.#########.#.###.#.#.#.###.#####.#.#####.#######.#.#######.#########.#######.#.#.#.
.#.#...#.#.......#.....#...#.#...#...#.....#.#...#.......#.....#.......#.#.....#.....#...#...#...#.
.#######.#####.#.#.###.#.###.#.#.###.#######.#.###########.###.#######.#.#####.#.#####.#.#########.
.#.......#.....#.#.#...#.#...#.#...#.#.......#.............#.#...#.....#.....#.#.#.....#...........
.#.#######.#######.#.###.#.#.#.###.#.###.###.###############.###.#.#####.#.###.#.#.#.#####.########
...#...............#.#...#.#.#.#...#...#.#...........#...#...#...#...#...#...#...#.#.#.....#.......
.#####.#############.#.###.###.#######.#.#.#########.#.#.#.###.#####.###.###.#######.#######.#####.
.....#.......#.....#.#.....#...#.....#.#.#.#...#.....#.#.#...#.#...#...#...#.......#.........#.#...
####.#######.#####.#.#####.#.###.#.#.#.#.#.###.#.#####.#.###.#.#.#####.#######.###.#######.###.#.#.
...#.#.....#.....#.#.......#.....#.#.#.#.#...#.#...#...#.#...#.#.....#.......#.#.#.......#.....#.#.
##.#.#.#########.#.###############.#.#.#####.#.###.#.###.#.###.#####.#######.#.#.#######.#######.#.
...#.#.#.......#.#...#.#.......#.#.#.#.#.....#...#...#.#.#...#.#...#...#...#...#.......#.........#.
.###.#.#.#####.#.#.#.#.#.#.###.#.#.###.#.#####.#.#####.#.###.#.#.#.#.###.#.###########.###########.
.....#.#.#...#.....#.#...#.#...#.#.....#...#...#.#.......#...#.#.#.#...#.#...........#...#.......#.
.#####.#.###.#######.#####.#.###.#########.#.###.#.#######.###.#.#.###.#.#.#########.#.#.#.#####.#.
...#.....#...#.....#...#...#.#.....#.......#...#.#.#.#.......#.#.#...#...#.#.......#...#.#.#...#.#.
##.#.#####.###.###.###.#.###.###.#.#.#.#########.#.#.#.#####.#.#.###.#####.#.#####.###.###.#.#.#.#.
...#.......#...#...#...#.#.#...#.#...#.#.........#.#...#.#...#.#...#.....#.#...#.#.#...#...#.#...#.
.#####.#####.###.#####.#.#.###.#.#####.#.#.#######.#.###.#.###.###.#####.#.###.#.#.###.#.###.#.###.
.#...#.#.....#.#.#...#...#...#.#.....#.#.#.#...#...#.#...#...#.....#.....#...#...#...#.#...#.#.#...
.#.#.###.#####.#.#.#.#####.#.#.#####.#.#.#.#.#.#.###.#.#####.#######.#######.###.###.#.###.#.#.#.##
.#.#...#.#.....#...#.#.#...#.#.#...#.#.#.#...#.#...#.#.#.......#.....#.....#...#.#.#.#.#...#.#.#...
.#.###.#.#.#########.#.#.#.#.#.#.#.#.#.#.#####.###.#.#.#.#######.###.#.###.###.#.#.#.###.###.#.###.
.#...#...#...........#.#.#.#.#...#.#.#.#.#...#.....#...#...#...#...#.#...#.#...#.#.#.....#...#...#.
.###.#####.###########.#.#.#######.###.#.#.#.#############.#.#.#.#.#.###.#.#.###.#.#######.#####.#.
.....#.....#.....#.....#.#.......#...#.#...#.#...#.........#.#.#.#.#.#...#.#...#.#.......#.#...#.#.
######.#####.#.###.###.#.#######.###.#.#####.#.#.###.#####.#.#.###.###.###.###.#.#.###.#.#.#.#.#.#.
.....#.#...#.#.#...#.#.#...#...#...#.#.#...#...#.#...#...#.#.#.#...#...#.#...#...#.#...#.#...#.#.#.
.###.#.#.#.#.#.#.###.#.###.###.###.#.#.#.#.#####.#.###.###.#.#.#.###.###.###.#.#####.###.#####.#.#.
...#.#...#.#.#.#.#...#...#...#...#.#.#...#.#...#.#.#.#.....#.#...#.......#...#...#...#.#.#.#...#.#.
.#.#.#####.###.#.#.###.#.###.#.#.#.#.#####.#.###.#.#.#.#####.#####.#######.#####.#.###.#.#.#.#####.
.#.#.#...#...#.....#...#...#...#.#.#.....#.#.#...#.#...#...#.......#...#...#...#...#...#.#.#.......
.#.###.#.###.#####.#.#####.#####.#.#####.#.#.#.###.#.#####.#########.#.#.###.#########.#.#.########
.#.#...#.....#...#.#.....#.#.....#.....#.#.#.......#...#.....#.......#...#.#...#.......#...#.....#.
##.#.#########.#.#.#####.#.#.#########.#.#.#.#########.#.###.#.###########.#.#.#.#.#######.#.#.#.#.
...#.#.........#.#...#...#.#...#.......#.#.#.#...#...#.#.#...#.....#.....#...#...#...#.....#.#.#.#.
.###.###.#####.#.#####.#######.#.#######.#.###.#.###.#.#.#########.#.#####.#####.###.#.#######.#.#.
...#...#.#.....#.#.....#.....#.#.#.......#.....#...#.#...#.........#.......#...#.#...#.......#.#...
.#.###.#.#.#####.#.###.#.###.#.#.#.#######.#######.#.###.#.#########.#######.#.###.#.#######.#.###.
.#.#...#.#.#...#...#...#.#.#.#.#...#.....#.......#.#.....#.........#...#.#...#.....#.#.....#...#...
.#.#.#####.#.#.#####.###.#.#.#.#########.#####.###.#####.#########.###.#.#.#########.#.#.#######.##
.#...#...#...#.#...#.#...#.#...#.#.........#...#...#...#...#...#.#.#.....#...#...#.#...#.#.....#...
.#####.#.#####.#.#.###.###.#####.#.#.#######.###.###.#.###.#.#.#.#.###.#####.#.#.#.#####.#.#.#####.
.......#.....#...#.....#...#.......#...#.....#...#...#...#...#...#...#.#...#.#.#.#.......#.#.....#.
############.###.#######.###.#########.#.#####.###.#####.#######.###.###.#.#.#.#.#########.#####.#.
...#.......#...#.....#.........#...#...#.#...#.#...#...#.#...#...#.#.....#.#...#.......#.......#...
.#.#.#####.###.#####.#########.###.#.#.#.#.#.#.#.#####.#.###.#.###.#######.#.#####.###.#.#######.##
.#.#.....#.#...#...#.......#.#.#...#.#.#...#.#.#...#...#.#...#.#.........#.#.#...#...#.#...#...#...
.#.###.###.#.###.#########.#.#.#.#.#.#######.#.###.#.###.#.###.###.#.#####.###.#.###.#.#.###.#.####
.#...#.#...#...#.........#.#.#.#.#.#.#...#...#...#.#.#...#...#...#.#.#.....#...#...#.#...#...#.....
.#####.#.#.###.#.#####.#.#.#.#.#.###.#.#.#.###.#.#.#.#.###.#.###.#.#.#.###.#.#####.#######.#######.
.......#.#.#...#.#.#...#.#.#.#...#...#.#.#.#...#.#.#.....#.#...#...#.#...#.#.....#.........#.....#.
.#######.#.#.###.#.#.#####.#.###.#.###.#.#.#.###.#.#####.###.#.#####.###.#######.###########.###.#.
...#.....#.#.#.....#.....#.#.....#.....#...#.#...#.#...#...#.#.....#...#.....#...#.........#...#.#.
####.#####.#.###.#######.#.###.#####.#######.###.#.#.#.###.#######.###.#####.#.###########.###.#.#.
...#.#.#...#...#.#.....#.#...#.#...#...#...#...#.#.#.#.#...#.........#.#.....#.......#.....#...#...
.#.#.#.#.#####.###.###.#.###.#.#.#.###.#.#.###.#.#.#.#.#.###.#########.#.###########.#.###.#.######
.#...#.......#.....#...#...#.#.#.#.#.#.#.#.#...#.#.#.#.#...#...........#.#...........#...#.#.......
.###################.###.#.#.###.#.#.#.#.#.#.#.###.#.#.###.#######.#####.#.#############.#########.
.............#.....#.#...#.#.....#.#.....#.#.#.#...#.#.#...#.....#.....#...#.....#.......#.........
.###########.#.#.###.#.###########.#.#######.#.#.###.#.#.###.###.#.#####.#####.#.#.#####.#.#######.
...#...#...#...#.#...#.#.........#.#.#.......#.#.....#.#.....#.#.#.#...#.......#.#...#...#.......#.
##.#.#.###.#####.#.###.#.###.#####.#.#.#.#####.#######.#######.#.###.#.#########.#.#.###.#######.#.
.#...#...#...#.#...#.....#.#...#...#.#.#.#...#.....#...#.......#.....#...#.....#.#.#...#.......#.#.
.#######.#.#.#.#####.#####.###.#.#####.#.#.#.#####.#.###.#####.#########.#.###.#.#.###.#######.#.##
.....#.#.#.#.#...#...#.......#...#.....#.#.#.....#.#...#.#...#.........#.#...#.#.#...#...#...#.#...
.###.#.#.#.#.#.#.#.###.#.#######.#.#####.#.#####.#####.#.#.#.#######.###.#.#.###.#######.#.#.#.###.
...#...#.#.#.#.#.......#.#.....#...#.....#...#.#.......#...#...#.....#...#.#.#...#...#...#.#.#...#.
.#.#####.#.#.###########.#.###.#####.#####.#.#.###############.#.#####.###.#.#.###.#.#.###.#.###.#.
.#.....#.#.#.....#.....#.#...#.#.....#...#.#.#...#.............#.....#.#.#.#...#...#...#...#.#...#.
.#####.#.#.#####.#.###.#####.#.###.###.#.#.#.#.#.#.#####.#######.#####.#.#.#######.#####.###.#.###.
.....#.#...#.#...#.#.......#.#...#.#...#.#.#.#.#.#...#.#.......#.#...#.#.#...#.....#...#...#...#.#.
######.#####.#.###.#######.#.###.#.#.###.###.#.#####.#.#######.#.#.#.#.#.###.#.#####.#.###.#####.#.
.....#.#.....#...#.#...#.#...#.#.#.#...#.....#...#...#.....#...#.#.#...#...#.#...#...#...#.....#.#.
.###.#.#.#.#####.#.#.#.#.#####.#.#.###.#######.#.#.###.###.#.###.#.#####.###.###.#.#####.#####.#.#.
.#.#.#...#.....#.#...#.#.....#...#...#.....#...#.#...#...#.#...#.#...#...#...#...#.#...#.....#...#.
.#.#.#.#####.###.#.###.#.#.###.#####.#####.#####.###.#.#.#####.#####.###.#.###.#.#.#.#.#####.###.#.
.#...#.#...#.#...#...#.#.#...#...#.......#.....#...#.#.#.#.....#...#...#.......#.#.#.#.#...#...#.#.
.###.###.#.#.#.#####.#.#####.###.#############.#.###.#.#.#.#####.#.###.#########.#.###.#.#.###.###.
...#...#.#.#.#...#...#.#...#...#...........#...#.#...#.#.#...#...#...#...#...#...#...#...#.#...#...
.#.###.#.#.#.###.###.#.#.#.###.###########.#.###.#.#####.###.#.###.#.###.###.#.#####.#.###.#.###.#.
.#...#...#...#.#...#.#.#.#.....#.......#...#.#...#.....#...#...#...#.#.#...#.......#.#...#.#...#.#.
####.#######.#.###.#.#.#.#######.#.#####.###.###.#####.#.#.#####.###.#.###.###.#####.###.#.###.#.#.
.....#.........#...#.#.#.#.....#.#.#.....#.....#.#...#...#.#...#...#.....#...#.#.....#.#.#...#.#.#.
.###############.#####.#.#.###.#.#.#.#########.#.#.#.#####.###.###.#########.###.#####.#.###.#.#.#.
S......................#.....#...#.............#...#.............#...............#.........#.....#.