.......#..........G
.#####.#####.######
...#.#.....#.#.#.#.
##.#######.#.######
...#.#.#.#...#.#.#.
.##################
.#.#.#.#.#.#.#.#.#.
.##################
.#.#.#.#.#.#.#.#.#.
.##################
.#.#.#.#.#.#.#.#.#.
.##################
.#.#.....#.#.#.#.#.
.###.###.##########
.....#.#...#.#.#.#.
########.#.########
.......#.#.#.#.#.#.
.#####.###.########
S#.#.#.....#.#.#.#.