.#.......#.....#.......#.......#.#.....#...............#...........#.....#.........#.....#.....#..G
.#####.#.#.###.###.###.#.###.#.#.#.###.#.#######.#.###.#####.#######.#.#.#.###.#####.#.#.###.#.###.
.......#...#.#.....#...#.#.#.#.#.#.#.#...#.....#.#...#.......#...#...#.#.#.#.#.......#.#.#...#.....
############.#######.###.#.#.#.#.#.#.#####.###.#.###.#######.#.#.#.###.#.#.#.#########.#.#.#######.
.........#.........#...#.#.#.#...#.....#...#.#.#.#...#.....#.#.#.....#.#.#.......#.....#...#...#...
.#.#####.#.#####.#####.#.#.#.#########.#.###.#.###.#.#.###.#.#.#######.###.#####.#.###.#####.#.#.##
.#.#...#.#.#...#.....#.#...#.#...#.....#...#.#.....#.#...#.#.#...#...#...#.#...#.#...#.#.....#.#.#.
##.#.#.###.#.#.#####.#.#####.#.#.#.#######.#.#######.###.#.#####.#.#.###.#.#.#.#####.###.#####.#.#.
...#.#...#.#.#.#...#.#.....#.#.#...#.....#.#...........#.#.#.....#.#.....#.#.#.....#.........#.#...
.###.###.#.#.###.#.#.#####.#.#.#########.#.#############.#.#.#####.#######.#.#####.###########.###.
.....#.#.#.#.....#.#...#...#.#.#...#.....#.#.........#...#.#.#...#.#.......#.#.#...#...........#...
.#####.#.#.###.###.#.###.###.#.#.#.#.#####.#.#######.#.###.#.#.###.#.#######.#.#.###.###########.##
.#.#...#.#...#.#...#.....#...#...#.#.#...#...#.....#.#.#.#.....#...#.#.....#.#.#.....#.#.....#...#.
.#.#.#.#.###.#.#.#########.#.#####.#.#.#.#####.###.#.#.#.#######.#.#.#.#.#.#.#.#######.#.#.###.###.
.#...#.#.....#.#.......#...#.....#...#.#.......#.....#.......#...#.#.#.#.#.#.#.........#.#.#...#...
.#####.###############.#.#.#####.###.#.#.#######.###########.#.#####.###.#.#.###.#####.#.#.#.###.#.
.....#...............#...#.#...#.#...#.#.#...#.....#.........#...........#.#...#...#...#.#...#...#.
####.###.###.#######.#.###.#.#.###.###.###.#.#.#####.#########################.###.#####.#####.#.##
...#...#.#...#.#...#.#...#...#.......#.#...#.#.#...........#.........#.......#.#...#...#...#...#...
.#####.###.###.#.#.#.#####.#########.#.#.###.###.###########.#######.#.#####.#.#.###.#.###.#######.
.....#.#...#...#.#...#...#.#.....#...#...#.#.....#...........#...#...#.#.....#.#.....#.....#...#...
.###.#.#.###.###.#####.#.#.#.###.#.#######.#######.#############.#.###.#.#####.#########.###.#.#.#.
.#.#...#.#.#.....#.....#.#.#.#...#.........#.......#...#.........#.....#.#...#.........#.#...#...#.
.#.#####.#.#.#####.#####.###.###.#########.#.#######.###.###.###.#######.#.#.###.#####.#.###.#####.
.......#.#.#...#...#...#...#...#.......#...#.#.#.......#.#.#...#...#...#...#...#.....#.#.#...#.....
######.#.#.###.#.#####.###.###.#######.#####.#.#.#####.#.#.###.#####.#.#######.#######.#.#.#####.##
.....#...#.#...#...#.....#...#.......#.......#...#...#.#...#.#.......#...#.....#...#...#.#.....#...
.#########.#.#####.#.###.###.#######.#########.###.###.###.#.###########.#.#####.#.#.###.#####.###.
...#.....#.#...#...#.#.....#.....#...#...#...#...#...#...#...#.....#...#...#...#.#...#.#.......#...
.#.#.#.#.#.###.#.###.###########.#.###.#.###.###.###.###.###.#.###.#.#.#####.#.#.#####.#########.##
.#.#.#.#.....#.#.#.#...........#...#...#.......#...#...#...#.#...#.#.#.......#...#.........#.....#.
.#.#.#.#######.#.#.#.#######.#.#####.#########.###.#.###.###.###.#.#####.#########.#.#####.#.#####.
.#...#.......#...#.#.....#...#.#.....#.....#...#.#.#...#...#...#.#.....#...#...#...#.#.....#.#...#.
.###########.#####.#####.#.###.#.#####.#.###.###.#.###.###.###.#.#####.#.#.#.#.#.###.#######.#.#.#.
.#.........#...........#.#...#.#.#.....#.........#.......#...#.#.#.....#.#.#.#.#.#...#.......#.#.#.
.#.#.#####.#.#####.#####.###.#.#.#.#############.#######.#.#.#.#.#####.###.#.###.#.###.#######.#.#.
...#.#...#.#.#...#.#.......#.#...#.#.#.......#.#.....#...#.#.#.#.....#.....#.....#.....#.......#.#.
####.#.#.###.#.#.###.#######.#####.#.#.#####.#.###.###.###.###.#####.#######.#################.#.#.
.....#.#...#.#.#...#.....#...#.......#.....#.#.....#.....#...#.......#...#...#...#.....#...#...#...
.#####.###.#.#.###.#.#####.#.#############.#.#######.#######.###########.#.###.#.###.#.#.#.#.#####.
.#.....#...#.#...#...#.....#.#.....#.....#.#...#...#...#.....#.#.......#.#.....#.....#...#.#.#.....
.#.#####.###.###.#####.#######.###.#.#.###.###.#.#.###.#.###.#.#.#.###.#.#################.#.######
.#.#.....#.........#.#...#...#.#.#...#...#...#...#.....#...#.#...#.#.#.#.....#...#.....#.#.#.......
##.#.#############.#.###.#.#.#.#.#######.###.#############.#.#####.#.#.###.#.#.#.#.###.#.#.#######.
...#.....#.......#.....#...#.#.#.......#...#...#...#.....#.#.......#.#.#...#...#.#...#...#...#.....
.#######.#.#####.#####.#####.#.###.###.#.#.###.#.#.###.#.#.#########.#.#.#######.###.###.###.#.###.
.#.....#.#.#.#...#...#.....#.#...#...#.#.#...#...#...#.#.#...#.......#.#.#.#...#.....#.#...#.#.#.#.
.#####.#.#.#.#.###.#.#######.###.#####.#.###.#######.#.#.###.#.#####.#.#.#.#.#.#######.###.#.#.#.#.
.....#.#...#.#.#...#.......#...#.....#.#...#.......#...#...#.#.#.....#...#...#...#.........#...#.#.
.###.#.#####.#.#.#########.#.#.#####.#.###.###############.#.#.#.#############.###.#############.#.
.#.#.#.....#.....#.......#...#...#.#.....#.#...........#...#.#.#...............#...#.........#...#.
.#.#.#.###.#.#####.#####.#######.#.#####.#.#.#########.#.###.#.#######.#.#######.###.#######.#.#.#.
...#.#...#...#...#.#...#.......#...#.....#.#.#.....#...#...#.#.......#.#.#.........#.#.#...#...#...
####.#########.#.#.#.#########.###.#.#####.#.#.###.#.#.###.#.#########.#.#.#########.#.#.#.########
.....#.......#.#...#.......#...#...#.....#...#.#...#.#...#.#...#.....#.#.#.......#...#...#.....#...
.###.#.#####.#.#####.#####.#.#####.#####.#####.#####.###.#.###.#.###.#.###.#######.###.#####.#.###.
.#...#...#.#...#.....#...#.#.....#.....#.#.....#.....#...#.#.#...#...#.....#.......#...#.#...#.....
.#######.#.#######.#####.#.#####.#####.#.#.###.#.###.#####.#.#####.###.#####.#######.###.#.#######.
.#.......#.......#.......#.....#.....#.#...#...#...#.#.....#.....#...#.#.....#.....#...#.#.#.....#.
.#.#######.#####.#######.###.#.#####.#######.#####.###.#####.###.###.###.#########.###.#.#.#####.#.
...#.#.....#.....#.......#...#.#...#...#.........#...#.....#.#.....#...#.........#.......#...#...#.
.###.#.#.#.#####.#########.###.#.#.###.#.###########.#####.###.#######.#########.#######.###.#.###.
.#.....#.#.#...#.......#...#.....#...#.#.#...#.......#.....#...#.....#.....#...#.....#...#.#.#...#.
.#####.#.###.#.#######.#.#############.#.###.#.#####.#.#####.###.###.#.#.#.#.#.#####.#.###.#.###.#.
.....#.#.....#.#.....#...#.......#...#...#...#.#...#.#.#.....#...#...#.#.#.#.#.....#.#.#...#...#...
####.#.#######.#.###.###.#.#####.#.#.#.###.#.#.#.###.#.#.###.#.#####.###.###.#####.#.#.#.#.###.#.##
.#...#.#.#.....#...#.....#.#...#...#.#.....#.#.#.....#.#.#...#.#...#...#.#...#...#...#...#...#.#...
.#.###.#.#.###.###########.#.#######.#######.#.#######.#.#.#.#.#.#.###.#.#.#####.#########.###.###.
.#.#...#.#.#...#...........#.#...#...#.......#.#.....#.#.#.#.#...#.#.#.#.#.........#.#...#.#...#...
.#.#.###.#.#.###.#####.#####.#.#.#.###.#######.#.###.#.###.#.#####.#.#.#.#########.#.#.#.#.#.#####.
.#.#.#...#.#...#.#.....#...#...#.#.#...#.......#.#.#...#...#.....#.#.........#...#.#...#...#.....#.
.#.#.#.#.#.###.#.###.###.#.###.#.#.#####.#######.#.#####.#######.#.###.#####.###.#.#######.#####.##
.#.#...#.#.#...#...#...#.#...#.#.#...#...#.....#...#.....#.....#.#...#.#...#.....#.#.....#.....#...
.#.#####.#.###.###.#####.###.#.#.###.#.###.###.###.#.#.#####.###.###.#.#.#.#####.#.#.###.#.#######.
...#.....#...#...#.....#.#...#.#.....#.......#...#.#.#.....#...#...#.#.#.#.....#.#...#...#.#.......
.###.#######.#########.#.#.###.#############.#.#.#.#.#####.###.###.#.###.#####.#######.###.#.#####.
...#.#.....#.........#...#.#.#.#...#.......#.#.#.#.#.....#...#...#.#.....#...#.........#...#.#.....
##.#.#.#############.#####.#.#.#.#.#.#.###.#.#.###.#########.###.#.#######.#################.#.####
...#.#.#.....#.........#.#.#.#.#.#...#.#.#.#.#...#...#.....#...#...#.....#...............#...#.....
.###.#.#.###.#.#######.#.#.#.#.#######.#.#.#####.###.#.###.###.#.###.###.#######.#######.#.#######.
.#.....#...#...#.....#...#.#.#.........#.#.....#...#.#.#.#...#.#.....#.#.#...#...#.....#.#.......#.
.#####.###.#####.###.###.#.#.###########.#####.#.#.#.#.#.###.#.#######.#.#.#.#.###.#####.#####.#.#.
...#.....#.#.....#.....#.#.#.........#.......#...#.#...#...#...#.......#.#.#...#.......#.....#.#.#.
##.#.#####.###.#.#######.#.#.#.#####.#.###########.#######.#####.#.###.#.#.###########.#####.###.##
...#.#...#...#.#.........#.#.#.#.......#.....#.....#.......#.....#.#...#...#.#.............#...#...
.###.#.#.###.#####.#####.#.#.#.#########.###.#.#####.#.###.#.#####.#.#######.#.#.#############.###.
.#...#.#...#.#...#.#...#.#.#.#...#.......#...#.#...#.#...#.#.....#.#.....#.....#.#.............#...
.#####.###.#.#.#.###.#.###.#.###.#.#######.#.#.#.#.#.###.#######.#.#######.#####.#.#############.##
.....#.#.....#.#...#.#.....#...#.....#.....#.#.#.#.#.#...#.......#.#.....#.....#...#.....#.....#...
####.#.#######.###.#.#########.#######.#.#####.#.#.###.#.#.#######.#.###.#####.#######.#.###.#.#.#.
...#.#...#...#.#.....#.....#...#.#...#.#.#.......#.....#.#.#.....#...#.#.....#...#...#.#...#.#...#.
.###.#.#.#.#.#.#####.#.###.#.###.#.#.#.###.###############.#.###.#####.#.#######.#.#.#.###.#######.
.#...#.#.#.#.#...#...#.#...#.#...#.#.#.#...#.............#...#.#...#...#.......#...#...#.#.........
.#.###.#.#.#.###.#.###.#.###.#.###.#.#.#.###.###########.#####.###.#.#.#####.###########.#########.
.#.#...#.#.#...#.#.#...#...#...#...#.#.....#.#.....#...#.......#.#.#.#.....#.#.......#.......#...#.
.#.#####.#.###.#.###.#####.#####.###.#######.#.###.#.#.#.#####.#.#.#.#####.#.#.###.###.#.###.#.###.
...#...#...#...#.#...#.....#...#.#.#.......#.#.#...#.#.#.....#...#...#...#.#.#.#...#...#...#...#...
.###.#.#####.#.#.#.###.#####.#.#.#.#######.#.#.#.###.#.#####.#########.###.#.#.#.###.#####.#####.##
S....#.......#.#.....#.......#...........#.....#.....#.....#...............#...#.........#.........
