.#.......#.....#.......#.....#.........#...............#.............#.....#.....#.....#..........G
.#.#####.#.###.###.###.###.#.#####.###.#.#######.#######.#####.###.###.#.#.###.#.###.#.#.#.#.######
...#...#...#...#...#.......#.....#...#.....#.....#...........#.#...#...#.#.....#...#.#...#.#.#.....
####.#######.###.###############.#######.###.#####.###########.###.#.###.#########.#######.###.###.
...#.......#...#...#.........#.........#.#...#.....#.....#...#...#.#.#.#.........#.......#.....#...
.#.#.#####.###.#.#.#.#######.#########.###.#.#.#####.#####.#.###.###.#.#########.#######.#######.#.
.#.#...#.#...#.#.#.#.#.....#...#...#.....#.#.#.....#.#.....#.....#...#.........#.....#...........#.
.#####.#.#.###.###.#.#####.###.#.#.#####.#.#######.#.#.###.#######.###.#############.#############.
.......#.#...#...#.#.#.....#...#.#.....#...#.....#...#...#.#.....#.....#.......#.....#.....#.....#.
.#######.###.###.#.#.#.#####.###.#####.#####.#.#####.###.###.###.#####.#.#####.#.###.#.###.#.###.#.
.#.......#.....#.#.#.#.....#.....#...#.....#.#.......#.#.....#.#...#.#.#...#...#...#.#.#.#.....#.#.
.#.###.#.#.#####.#.#.#####.#########.#####.#.#########.#######.#.#.#.#.###.###.#.#.###.#.#######.#.
.#...#.#.#.......#.........#...........#...#.#.........#.......#.#...#.#.#...#.#.#...#...#.....#.#.
.#.###.#.###########.#####.#######.###.#.###.###.#####.#######.#.#####.#.###.#.#.###.###.#.###.#.#.
.#.#...#.#.........#.#...#.#...#...#...#...#.....#...#.....#...#...#...#.#...#.#.#.#.....#.#...#.#.
.###.###.#####.###.###.#.#.#.#.#.###.#####.###.###.#.#####.#.#.###.#.###.#.###.#.#.#######.#.###.##
.#...#.#.......#.#.....#.#...#...#.....#.#.....#...#.#...#.#.#.#.#.#.#...#...#.#...#.#.....#.#.....
.#.###.#########.#######.#.###########.#.#######.###.#.#.#.#.#.#.#.#.###.###.#.###.#.#.#####.#####.
...#.....#.......#.....#.#.#...#.....#.....#...#.#...#.#.#...#...#.........#.#.#...#.#...#.#.......
######.#.#.#####.#.###.#.###.#.#.###.#####.###.#.#.###.#.#################.#.#.#.###.###.#.#######.
.......#...#...#.#.#.#.#.....#...#.#.#.........#.#.....#.................#.#.#.#.....#...#.....#...
.#.#####.#####.#.#.#.#.###########.#.#.#########.#######################.###.#.#######.###.#.###.##
.#.#.....#...#...#.#.#.........#...#.#.#...#...#.#.............#...#.....#...#.#.......#...#.#...#.
##.#.#####.#.#####.#.#########.#.#.#.#.###.#.#.#.###########.#.#.#.#.#####.###.#.###########.#.###.
...#.#.....#.#.....#.........#...#...#.....#.#.#...........#.#.#.#.#.......#.#.#...#.........#.#...
.#####.#####.#.#####.#######.###############.#.###.#######.#.#.###.#########.#.#.#.#.###.#.###.###.
.....#.#...#.#.#.........#.#.#...#.........#.#...#...#...#.#.#.#...#.........#.#.#.#...#.#.#...#...
.###.#.#.###.#.#####.###.#.#.#.#.#####.###.#.###.#####.#.#.#.#.#.#.#####.###.#.###.###.#.#.#.###.##
...#...#.#...#.....#.#...#.#...#...#...#...#.#.........#...#.#.#.#.....#.#...#...#.#...#.#.#...#...
##.#####.#.#.#####.###.###.#######.#.###.###.###############.#.#.#####.#.#.#####.#.#####.#.###.###.
.#.....#.#.#.....#.#...#.....#...#...#.#...#.....#.#.........#.#.#.#...#.#.....#.#...#...#.#...#...
.#####.#.#.#.#####.#.###.#####.#.#####.###.#.###.#.#.#####.###.#.#.#.###.#####.#.###.#.#####.###.##
.....#...#.#.#.....#...#.......#.#.........#...#.#.#.#.....#.#...#.#.#...#...#.#.....#.#...#.#.....
##.#.###.#.###.#######.#.#######.#.#############.#.#.#.#####.#####.#.#.###.#.#.#######.#.#.#.#####.
...#.#...#.....#.......#...#...#.#...#.........#.#...#...#.....#.....#.....#.#.........#.#.#.#.....
.###.#.#########.###.#####.###.#.###.#####.###.#.###.###.#.###.#.#######.#########.#####.#.#.#.###.
.#.#.#.......#...#.#...#.#...#.#...#.....#.#.#.#...#...#.#.#.#.#.......#.#...#.....#.....#...#...#.
.#.#.#######.###.#.###.#.###.#.###.#####.#.#.#.#.#.#####.#.#.#.#######.###.#.#.###.#.###########.#.
.#...#.....#...#...#...#...#.#...#.....#.#.#...#.#.#...#.#...#.......#.....#.#...#.#...#.......#.#.
.#.#####.#.###.#####.###.#.#.###.#####.#.#.###.###.#.#.#.###########.#######.#.#.#####.#.#####.#.##
.#.......#...#.....#...#.#.#.#.....#...#.#...#.....#.#...#.........#...#.....#.#...#...#...#.#.#...
.#########.#######.#.#.#.###.#.#.###.#.#.###.#######.#####.#######.#.###.#########.#.#####.#.#.#.#.
.....#.....#.......#.#.#.......#.#...#.#.....#.......#.....#.....#.#.....#.......#.#.......#.#.#.#.
.###.#.#####.#######.#.###.#######.###.#############.#.#####.###.#.#.#######.###.#.#########.#.#.#.
...#.#.#.....#.......#...#.#...#...#.....#...........#.#.#...#.....#.........#.#.#.....#...#...#.#.
####.###.#########.#####.###.#.#.#######.#####.#.#####.#.#.#########.#########.#.###.#.#.#.#.#####.
.....#...#.......#.#...#.....#.#.......#.....#.#.#.....#.#.........#.#.....#...#.....#.#.#.#.#...#.
.#####.###.#####.###.#.#######.#.#####.#####.#.#.#.#####.#########.#.#.###.###.#######.#.#.#.#.#.#.
.#.....#.....#.#.#...#.........#.....#...#.....#.#...........#...#.#.#.#.#.#...#.....#.#.#.#.#.#.#.
.#.#####.###.#.#.#.#############.#######.#.###############.###.#.#.###.#.#.#.###.###.#.#.#.#.#.#.#.
.#.#.......#.#...#.........#.#...#.......#...#.....#...#...#...#.#.#.....#.#.#.....#.#...#.#...#.#.
.#.#########.###.#########.#.#.###.#########.#.###.#.#.#.###.###.#.#.#####.#.#.#####.#####.#####.#.
.#.........#...#...#.......#...#...#.#.......#...#...#...#...#...#.#.#.#...#...#...#...#...#.#...#.
.#########.###.###.#.#######.###.###.#.#########.#########.###.###.#.#.#.#.#####.#.#.#.#.###.#.###.
.....#...#...#...#...#.#.......#.#.....#.........#.....#...#...#.......#.#.#.....#.#.#.#.#...#...#.
.#.###.#.###.###.#####.#.#######.#.#####.#########.#.###.###.###########.###.#####.#.###.#.#.###.#.
.#.....#...#.....#.......#.#.....#.#.....#.#...#...#...#...#.........#...#...#.#...#...#.#.#...#...
.#########.#######.#######.#.#######.#####.#.#.#.#####.###.#########.#.###.###.#.#####.#.#####.###.
...#.............#.#.......#...#.....#.......#.....#.....#.#.......#...#...#...#.....#.#.....#.#...
##.#.#########.###.#.#########.#.###########.#######.#####.#.#####.#####.###.#.#####.#.#####.#.#.##
.#.#...#.#.....#...#.#.....#...#...#.......#.#.....#.#...#.#...#...#.....#...#.....#.#.....#.#.#.#.
.#.###.#.#.#####.###.#.###.#.#####.#.#.###.###.###.#.#.#.#.###.#.###.#######.#######.#.#####.#.#.#.
.#.#...#...#...#...#...#...#.....#.#.#...#...#...#...#.#.....#.#...#.#.......#.......#.#.......#...
.#.#.#######.#.###.#.###.#.###.#.#.#####.###.###.#####.#######.###.#.###.###.#.#######.#.#########.
...#...#...#.#...#.#...#.#...#.#.#.#...#...#.#...#.....#.......#.#...#...#...#.....#.......#.....#.
####.#.#.#.#.###.#.#####.#####.###.#.#.###.#.#.#.#.###.#.#######.#####.#####.#####.#######.#.###.#.
...#.#...#.....#.........#.....#...#.#.#...#...#.#.#...#.....#.............#.#.....#.....#.#...#...
.#.#######################.#####.###.#.#.#######.#.###.#####.#####.#######.###.###.#.###.#####.####
.#.........................#.........#.#.#.....#.#...#.#...#.....#.....#...#...#...#.#.#.....#...#.
.#############.#####.#######.#########.#.###.#.#.###.#.###.#####.#######.###.###.###.#.###.#####.#.
...#.........#.#...#.#.........#...#...#...#.#...#...#...#.....#.....#...#...#.#...#...#.#.#...#...
##.#.#######.#.#.#.###.#########.#.#.#####.###.###.#####.#.###.#####.#.###.###.#.#####.#.#.#.#.###.
...#.#.....#...#.#.....#...#...#.#.#.....#...#.#...#.......#...#.#.....#...#...#.#.......#.#.#.....
.###.#.###.#####.#######.#.#.#.#.#.#####.###.#.#.###########.###.#.#####.#####.#.#.#######.#.######
.#...#.#...#.....#.......#.#.#...#...#.#.#...#.#.....#.....#.....#.#.....#...#...#.#...#...#.#.....
.#.###.#####.#####.#.#####.#.#######.#.#.#.#########.#.###.#######.#.#####.#.#####.#.###.###.#.###.
.#.....#.....#.....#...#...#.#.....#.#.#...#.....#...#.#.#...#.....#.......#.........#...#...#.#...
.#.#####.#####.#######.#####.###.#.#.#.###.#.###.#.#.#.#.###.#.#######################.#.#.###.#.#.
.#.#.....#...#...#...#.#...#...#.#.#.#.#...#...#...#.#.....#...#...#.........#.........#.#.#...#.#.
.#.#.#####.#####.###.#.#.#.###.#.#.#.#.#.#####.#####.#####.#######.#.#####.###.###.#######.#.###.##
.#.#...#.............#...#...#.#.#.#.#.#...#.#...#...#...#.......#...#...#.#...#...#.......#...#...
.#####.#.#####.#####.#####.#.#.###.#.#.###.#.###.#.#####.#######.#.###.#.#.#.#######.###########.#.
.....#.#.#...#.#...#.#.....#.#...#...#.........#.#.........#...#.#.#...#...#.........#.....#...#.#.
.#.###.###.#.###.#.###.#####.###.#.###.#########.#########.###.#.###.#####.#############.#.#.#.#.#.
.#...#.#...#.....#.....#...#...#.#.#...#.....#...#.......#.....#.#...#...#.#...#...#.....#...#.#.#.
.###.#.#.#####.#########.#.#####.#.###.#.###.#.###.#####.#####.#.#.###.#.#.#.#.#.#.#.#########.###.
.#.#...#.#.....#.....#...#.......#...#.#.#.#...#...#.....#.#...#.#...#.#.#...#...#...#.......#...#.
.#.#####.#######.###.#.#############.#.#.#.#####.#.###.###.#.###.###.#.#.#############.#########.#.
.#...#.....#...#.#.#.#.....#.#.......#.#.#...#...#...#.....#.#.#...#.#.#...#.#.......#...........#.
.#.###.###.#.#.#.#.#.#####.#.#.#########.#.###.#####.#######.#.###.#.#.###.#.#.#####.#.###########.
.#.....#...#.#.....#...#...#.#.......#...#.....#...#...........#...#.#.#.#.#.#.#...#.#...#.........
.#####.#.###.#########.#.###.#######.#.###.#####.#.###########.#.###.#.#.#.#.#.#.#.#.###.#.#.#####.
.#...#.#.....#...#.....#.#.............#.......#.#...#.......#.#.#.#.....#.#.#...#.#.....#.#.#.#...
.#.#.#########.#.#.#####.#.#########.#########.#.#####.#####.###.#.#.#####.#.#####.#########.#.#.##
...#...........#...#.....#.....#...#.#.....#.#...#...#.....#.....#...#.....#...#...#.......#.#.#...
################.###.#######.###.#.#.#.###.#.###.#.#.#####.###########.#######.#.#####.###.#.#.###.
...#.........#...#...#...#...#...#.#.#...#.#.....#.#.....#...#.......#.....#...#.#.....#.#...#...#.
.###.#######.#.###.###.#.#####.###.#####.#.#######.#.#######.#####.#.#####.#.###.#.#####.#####.#.#.
S..........#.....#.....#.........#.......#.........#...............#.......#.......#...........#...