.#...........#...#.....#...........#.....................#...#.........#.............#.....#......G
.#.#######.#.###.#.#.###.###.#####.###############.#.###.#.#.#.#####.#.#.###########.#.###.#.###.#.
.#.....#...#.....#.#.......#.....#...............#.#...#...#.#...#.#.#...#...#.....#...#.#.#.#...#.
.#####.#.#######.#.###########.#.###############.#.###.#####.###.#.#.#####.#.#.#.#.#####.#.###.###.
.....#.#...#...#.#.....#.....#.#.#.........#...#.#...#...#.....#...#.......#.#.#.#.......#.#...#...
####.#.###.#.#.###.#####.###.###.#.#######.#.#.#.###.###.#########.#########.#.#.#########.#.#####.
...#.#...#.#.#.....#.....#.#...#.#...#.....#.#.#.#.....#.........#...#.....#.#.#...#...#...#.....#.
.###.###.#.#.#######.#####.###.#.###.#######.#.#.#.###########.#.###.###.#.#.#.###.#.#.#.#######.#.
.....#.#.#...#.....#...#.....#...#...#.......#...#...#.......#.#...#...#.#.#.#.#...#.#.#.#.......#.
.#####.#.#######.#.###.#.###.#####.#.#.#############.#.#####.#.#######.#.#.#.#.#.###.#.#.#.#######.
.#...............#...#.#.#...#.....#.#.......#.....#.#...#.....#.........#.#.#.#...#.#...#...#.#...
.#####################.#.#.#.###.###########.#.###.#.###.#######.###########.#####.#.#######.#.#.##
.#.......#.......#.....#.#.#.....#.......#...#...#.....#.......#.#...........#.....#.....#...#...#.
.#.#####.#.#####.#.#######.#.#####.#####.#.#####.#############.#.#.###########.#.#######.#.###.###.
.#.#...#.#...#...#.#.......#.#...#.#...#...#...#...#.......#...#.#.....#.......#.#.........#.#.....
.#.#.###.###.#.###.###.#######.#.#.###.#####.#.#####.#####.#.###.#####.###.#.#####.#########.#####.
.#.#.........#.#.#...#.....#...#.#.......#...#.#.....#.#...#...#.....#...#.#.......#.....#.#.....#.
.#.#.#########.#.#.#.###.#.#.###.#######.#.#.#.#.#####.#.###.#.#####.###.#.#####.###.###.#.#.#.#.#.
.#.#.#.....#...#...#...#.#...#...#.......#.#.#.#...#...#.#...#.....#...#.#.#...#.#...#...#...#.#.#.
.#.###.###.#.###.#####.#######.###.#########.#.###.#.###.#####.#.#####.#.#.#.#.###.###.###.###.#.#.
.#.....#.#.#...#.#...#.#.......#...#.........#.#...#.....#.....#.#.....#.#.#.#.#...#.#.#.#.#.#.#.#.
.#####.#.#.###.###.#.#.#.#######.#######.#####.#.###.#####.#####.#.#####.###.#.#.###.#.#.#.#.#.#.#.
.....#...#...#.#...#...#.......#.....#...#.....#...#.....#.#...#.#...#...#...#.#.....#.#.....#.#.#.
####.###.###.#.#.###########.#.#####.#.###.#####.#.#####.#.#.#.#####.#.###.###.#####.#.#####.#.###.
.#...#.#...#.#...#.#.......#.#.....#.#.#...#...#.#...#.....#.#.....#.#.#...#.......#.#...#.#.#.....
.#.###.###.#.#####.#.#.###.#######.#.#.#.###.#.#.###.#.#####.###.###.#.#.###.#####.#.###.#.#.######
...#.......#.#.#...#.#...#.....#...#...#.#...#.#.#...#.#...#...#.....#...#...#...#.#.#...#...#.....
.#####.#####.#.#.#.#.###.#####.#.#######.#.#####.#.#####.#.###.###########.###.#.###.#.###.###.#.##
.....#.....#.#.#.#.#...#...#...#.#...#...#.....#.#...#...#...#.#.........#.#...#.....#...#...#.#...
####.#######.#.#.#.###.###.###.#.#.#.#.#######.#.###.#.#####.#.#.#######.#.#.###########.###.###.#.
.#...#.......#...#.....#.#...#.#.#.#...#.....#.#.#.#...#...#...#.....#.#.#...#.........#.#.....#.#.
.#.###.###########.#####.###.#.#.#.#####.###.#.#.#.#######.#########.#.#.#####.#######.#.#####.#.#.
...#.#.....#.....#.......#.#.#...#...#.#...#.#.#.#.......#.....#.....#.#.#...#.#.....#.#...#...#.#.
.###.#.###.#.###.#######.#.#.#######.#.#.#.#.#.#.#.#####.#.#.###.#####.#.#.#.#.#.#.#.#.###.#.###.#.
.#...#.#.#...#...#.....#...#.....#...#.#.#.#.#.....#.....#.#.#...#.....#...#...#.#.#.#.#...#.#...#.
.#.#.#.#.#####.###.###.###.#####.#.###.#.#.#.#########.###.#.#.###.#.###########.#.#.#.#.###.#####.
.#.#.......#...#...#.#.#.#...#.#.#.#.....#.#.....#...#.....#.#.#.#.#...........#.#.#.#.#...#.....#.
.#.#########.###.###.#.#.###.#.#.#.#######.#####.#.#.#########.#.#.#####.###.###.#.###.#.#.#####.#.
.#.....#...#.....#...#.#...#...#.#...#.....#...#...#.#.........#...#.....#...#...#.....#.#.....#.#.
.#####.#.#.###.###.###.#.###.###.###.#.#####.#######.#.#########.###.###.#####.###############.#.#.
.#...#.#.#...#.....#...#.....#.....#...#.......#...#.#.#.......#...#.#.#.#.....#.............#.#...
.#.#.###.###.#####.#.#.#####.#.#########.#####.#.#.#.#.#.#####.#####.#.#.#.#####.###########.#.###.
...#.#...#.......#.#.#.#...#.#.........#...#...#.#...#.#...#.......#.#.#.#.#.........#.....#.#...#.
####.#.#########.###.#.#.#.#.#######.#.#####.###.#####.#.#.#######.#.#.#.#.#####.###.#.#####.###.##
.....#.......#.......#.#.#.#...#.....#.....#...#.#.....#.#.#.....#...#...#.....#.#...#.#...#...#...
.#########.#.#######.###.#.#####.#########.#.#.#.#.#.###.#.#.###.#######.#####.#.#.###.#.#.###.#.#.
.#.......#.#...#.....#...#.....#.......#...#.#.#.#.#.#.#.#.#...#.#.....#...#...#.#.#...#.#.....#.#.
.#.#####.#####.#######.#######.#####.#.###.###.#.###.#.#.#.###.#.#.###.###.#.#####.#.###.#########.
.#.#.....#...#.......#.#...#.#.....#.#...#.....#.....#.#.#.....#...#.#.#...#.......#...#.#.........
.#.#.#####.#.###.###.#.#.#.#.#####.###.#.#####.#######.#.###########.#.#.#############.#.#.#######.
.#.#...#...#...#...#.#.#.#...#...#...#.#.....#.#.......#.......#.....#.#.#.............#.#.#.....#.
.#.###.#.#####.#.###.#.#.###.###.###.#.#####.#.#######.#######.###.#.#.###.###.#######.#.#.#.###.##
.#.#.#...#...#.#.#...#.#...#.......#.#.....#.#.....#.....#...#.....#.#...#.#...#...#...#.#.....#...
.#.#.#####.#.#.#.#.###.###.#######.#.#.#####.#####.#.###.###.#######.###.#.#.###.#.#####.#####.###.
.#.#.....#.#.#.#.#.........#...#...#.#.#.....#...#...#.#.#.......#.#...#...#.....#.......#...#...#.
.#.###.#.#.#.#.#.###########.#.###.#.###.#####.#.#####.#.#.#####.#.###.###################.#.#####.
...#...#...#.#.#.#...#.......#...#.#.#...#...#.#.#.........#.......#...#...#.........#.....#.......
####.#######.#.#.#.#.#.###.#####.###.#.###.#.#.#.#################.#.###.#.###.#.###.#.#.#########.
...#...#.....#.#.#.#...#...#...#.....#.#...#...#.#.......#.....#.#.#.....#...#.#.#...#.#.#.........
.#.#.#.#.#####.###.#########.#.#######.#.#####.#.#.#####.#.###.#.#.#########.#.#.###.###.###.######
.#...#.#.#...#...#.#.........#.......#...#...#.#...#...#...#.#.#.#.......#...#.#...#...#...#.......
.#####.#.###.###.#.#.###############.#.###.#.###.#####.#####.#.#.#######.#.#######.###.###.#######.
.....#.#.....#...#.#...#.....#.......#.#...#...#...#...#...#.#.#.#.......#.........#.#...#...#.#...
####.#.#######.###.###.#.###.#.#######.#.#####.###.#.#.#.#.#.#.#.#.#################.###.###.#.#.##
...#.#.......#...#.......#...#.....#...#.#...#...#.#.#.#.#.#.#.#...#...............#.#...#...#...#.
.#.#.#######.###.#######.#########.#.###.#.#.###.#.#.#.#.#.#.#.###.#######.#######.#.#.###.###.###.
.#.#.....#.....#.#.....#.#.........#...#...#.#...#...#...#...#...#.........#.....#...#.#...#...#...
.#.###.###.###.#.#.###.###.###############.#.#.#############.###.#########.#.###.#.###.#.###.#####.
.#.....#...#...#.#...#...#...#...#.......#.#.#.#.#...........#...#...#.....#.#.#.#.#...#.#.#.......
.#######.###.###.#.#.###.###.#.#.#.#####.###.#.#.#.#####.#####.###.#.#.#####.#.#.###.###.#.#######.
.#.....#.#.....#.#.#...#...#.#.#...#.........#.#...#...#.#...#.#...#.#.#...#...#.....#...#.........
.#.###.#.#.#####.#.###.###.#.#.###############.#####.#.#.#.#.#.#.###.#.###.###.#######.###.########
...#...#.#.#.....#...#...#...#.#.........#...#...#...#.#.#.#...#.#...#.....#.#.#.......#.#.......#.
####.###.###.#######.###.#####.#.#######.#.#.###.#.###.###.###.#.#.#######.#.#.#####.###.#######.#.
.#...#.#.#...#...#.....#.#.....#.#.......#.#.#...#.#.......#...#.#.......#...#.#...#.#.....#.#...#.
.#.###.#.#.###.###.#####.#.#.###.#.#########.#.###.#####.#######.#######.#####.#.#.#.#.###.#.#.###.
...#...#...#.........#...#.#.#...#...#.....#.#.#.....#...#.......#...#...#.....#.#.#.#...#...#...#.
.###.#.###############.#####.#.#####.#.###.#.#.#.###.#.###.#######.#.#.#.#.#####.#.#.#.#.#######.#.
.#...#.#.#...........#.#...#...#...#.....#.#.#.#.#...#...#.#...#...#.#.#.#.#.....#.#.#.#...#...#...
.#.#.#.#.#.#.#######.#.#.#.#.###.#.#####.#.#.#.###.#######.#.###.#.#.#.#.#.###.###.#.#.###.#.#.###.
.#.#.#.#...#.#...#...#...#.#...#.#.#...#.#.#.#...#.....#...#.....#.#.#.#.#...#...#...#...#.#.#.....
.###.#.###.#.#.#.#.#######.###.#.###.#.###.#.###.#####.#.###.#####.#.#.#.###.#.#.#######.#.#.######
.....#...#.#.#.#...#.......#.#...#...#.....#...........#.#.#.#.....#.#.#...#.#.#.#.....#.#...#...#.
########.###.#.#######.#####.###.#.###.###############.#.#.#.#.#####.#.###.#.###.#.#####.#####.#.#.
...#.....#...#.........#...#.....#.#...#...#...#.......#.#.#.#.#.....#.#.#.#.....#.....#.#.....#.#.
.#.#.#####.#############.#.#.#####.#.###.#.#.#.###.#####.#.#.#.#######.#.#.###########.#.#.#####.#.
.#.#.#.....#.......#...#.#.......#.#.#...#.#.#...#...#...#.#.#.....#...#.#.#.#.........#...#...#.#.
##.#.#.#####.###.#.###.#.#########.#.#.###.#.###.#####.###.#.#####.#.###.#.#.#.###.#########.###.#.
...#...#.#...#...#...#...#.....#...#.#.#...#...#.......#...#.#.#...#...#.#.#...#...#.......#.....#.
.#######.#.###.#####.#####.###.#.#####.#.#####.#########.###.#.#.#####.#.#.#.###.###.###.###.#####.
.#.........#...#.......#...#.....#.....#.#.....#.........#.....#...#...#...#...#...#.#.#.....#.....
.#.#########.#########.#.#######.#.#####.#.#####.#.#####.#.#######.#.#####.#######.#.#.#######.####
.#.....#...#.#.....#.....#.....#.#.....#...#.....#.....#.#.#.#.....#.....#.......#.#.#.......#.....
.#####.#.#.#.#.###.#.#####.###.#######.###########.###.###.#.#.###.#####.#######.#.#.#######.#.###.
.....#.#.#...#.#.#.#...#...#.#.......#...........#...#...#.#.#.#.....#...#.....#...#.......#.....#.
.###.#.#.###.#.#.#.#####.###.#######.###########.#####.#.#.#.#.#######.#######.#.#########.#.#####.
...#...#.#...#.#.#.....#.#.......#.#...........#.....#.#.....#.......#.......#...#.......#.#.#...#.
##.#####.#####.#.#####.#.###.###.#.#######.#########.###############.#######.#####.#####.#.###.#.#.
S......#.............#.......#...........#.................................#...........#.......#...