.#...............................#.........#.........#.....#.......#.......#...#..................G
.#################.#####.#######.#.#.#######.#####.#.#####.#.#.###.#.#######.#.#.###.#########.####
.............#...#.....#.#.#...#.#.#.......#.#.#...#.....#.#.#.#.....#.......#.....#.....#.....#...
############.#.#.###.###.#.#.#.#.#.#######.#.#.#.#######.#.#.#.#######.#################.#######.#.
.......#...#.#.#...#.#...#...#...#...#.#...#.#.#.#.........#.#.........#.#...............#...#...#.
.###.###.#.#.#.###.###.#############.#.#.###.#.#.#.#######.#.###########.#.#####.#######.#.#.#.###.
...#.....#.#.#...#.#...#.....#.....#...#.....#.#.#.#.....#.#.#.......#...#...#...#...#...#.#.....#.
##.#######.#.###.#.#.#.#.###.#.#.#####.#######.#.###.###.###.#.#######.#.###.#####.#.#####.#######.
.#.#.....#...#...#...#.#.#.#.#.#...............#.......#.#...#.#.....#.#...#.#.....#...........#...
.#.###.#######.#########.#.#.#.###############.#########.#.###.#.###.#.###.#.#.###############.#.##
.#...#.........#...#...#...#.#.....#.......#.........#...#.#...#...#.#...#.#.....#.......#.....#...
.###.#######.###.#.#.#.###.#.#####.#.#####.###########.#.#.#.#####.#.#.###.#######.#####.#.#######.
...#.......#.#...#.#.#...#.#...#...#.#...#.............#.#.#.......#...#...#.......#...#.#.#...#...
.#.#######.#.#.###.#.###.#.#.#.#.###.#.###########.#####.#.#.###########.#.#.#######.###.###.#.#.##
.#.....#...#.....#...#.#...#.#.#.#...#...........#.#...#.#.#...#.......#.#.#.....#.#...#.....#.#...
.#.#####.#######.#####.#####.###.#.#########.#.###.#.#.###.###.#.###.#.#.#######.#.#.#.#######.###.
.#.....#.......#.#.......#...#...#.....#...#.#.....#.#.....#...#.#...#.#.......#.#...#.............
.#####.#######.#.###.###.#.###.#######.#.#.###.#####.#######.#####.#########.#.#.#.###############.
.....#.....#.#.#...#.#...#.....#...#...#.#...#.....#.#.............#.........#.#.#...#...........#.
####.#.###.#.#.###.###.#.#######.###.###.###.###.###.#.###########.#.#########.#.###.#.#########.#.
...#.#...#...#...#.....#...#...#.#...#...#...#...#...#...#...#.....#.......#.#.#...#.#...#.....#.#.
.###.###.###.###.#########.#.#.#.#.###.###.###.###.#####.#.#.###.#########.#.#.###.#.###.#.###.#.#.
.#...#.#.#...#.#.....#...#.#.#...#.......#.#...#.#...#...#.#...#.#.....#...#...#...#...#.#.#.....#.
.#.###.#.###.#.#####.#.#.#.#.###.#########.#.###.###.#####.###.#.###.###.###.###.#######.#.########
...#...#...#...#.....#.#...#.#...#.....#...#.....#...#.....#.#.#.....#...#.....#.....#...#.#.......
.#####.###.#####.#####.#####.#####.###.#.#########.###.#####.#.#.#####.###.#######.#.#.###.#.#####.
.......#.#.....#.....#...#.......#...#...#...#...#.#...#...#...#.#.....#...#.....#.#.#...#...#.....
######.#.#####.#####.###.###.###.###.###.#.#.#.#.#.#.###.#.#.#####.#########.###.###.###.#####.###.
...#...#.....#.....#.#.#...#...#.#...#...#.#...#...#.#.#.#...#.....#.........#.#.....#...#...#...#.
.#.#.#######.#.#####.#.###.###.#.#.#####.#.#########.#.#.#####.###.#.#########.#####.#.###.#.#.#.#.
.#.#.#.......#.#...#.#.....#...#.#.....#.#.#...#.....#.#.....#.#.#.#.......#.........#.#...#.#.#.#.
##.#.#.#####.#.#.#.#.#.#####.###.#####.#.#.#.#.#####.#.#####.#.#.#.#######.###########.#.###.###.#.
...#...#.#...#.#.#...#.....#.#.#...#...#.#...#.#...#.#...#...#.#.........#.............#...#.....#.
.#######.#.###.#.#########.#.#.#.#.#.#.#######.#.#.#.#.###.###.#########.#################.#######.
.......#...#.#...#.......#.#.#.#.#.#.#.#.....#.#.#...#.....#...#...#...#...#.....#.....#.#.#...#...
##.###.#.###.#####.#.###.#.#.#.#.###.#.#.#.#.#.#.#####.#####.###.#.#.#.###.###.#.#.#.#.#.#.#.#.#.##
...#...#.#.....#...#.#.#.#.#...#...#.#.#.#.#.#.#.#...#.#.....#...#...#...#...#.#...#.#...#.#.#...#.
.###.###.#.#.###.###.#.#.#.#.#####.#.#.#.#.###.#.#.###.#.#.###.#######.#.###.#####.#.#####.#.#####.
.#...#.#.#.#.#.....#.#...#.#.#...#.#.#.#.#...#...#.....#.#.....#.....#.#.#.#.....#.#.....#.#...#...
.#.###.#.###.#.#####.#.###.#.#.#.#.#.###.###.#####.#############.###.###.#.#####.#.#####.#.###.#.##
.#.....#...#.....#...#...#.#.#.#...#.#...#.#.....#...............#.#.....#...#.#.#.#...#.#.#.#.#...
.#####.###.#####.#.#######.###.#####.#.###.#.#####################.#######.#.#.#.###.#.#.#.#.#.#.#.
...#.#.#.#...#...#.#.....#...#.....#...#...#.............#.........#.......#...#.....#.#.#.#...#.#.
##.#.#.#.###.#.###.#.###.###.#.###.#######.#####.#######.#.#######.###.#####.###.#####.#.#.###.###.
...#.#.....#.#...#...#...#...#.#...#.......#...#.#.....#.#.#...#.......#.....#...#...#...#...#.....
.###.#####.#.###.#####.###.#####.###.###.#.###.#.#.#####.#.#.#.#####.#####.###.###.#.#######.#####.
.#.....#...#.#.......#.#...#...#.....#...#.....#.#.....#.#...#.#...#.#...#.#...#...#.......#.#...#.
.#.#.###.###.#######.#.#.###.#.#.#####.#######.#.###.#.#.#.###.#.#.#.#.#.###.###.#########.#.#.#.##
.#.#.....#...#.....#.#...#...#.#.#...#.......#.#...#.#...#.#.#...#.#.#.#...#.#.#.#...#.....#...#...
.#########.###.###.###.###.#.#.#.###.#######.#####.#.#####.#.#####.#.#.###.#.#.#.#.###.#######.###.
.........#.#...#.#...#...#.#.#.#.....#.....#.#.....#.....#.......#.#.#.#...#...#.#...#.......#.#...
.#######.#.#.###.###.###.###.#.#####.#.###.#.#.#########.#########.#.#.#.#####.#.###.#######.###.#.
.....#...#...#.....#...#.....#.....#...#...#.#.........#...........#.#.#.......#.#...#.....#.....#.
####.#.#.#####.#######.###.#######.#####.###.#########.#############.#.#########.#.###.###.#######.
.....#.#.#...........#.#...#...#.....#.#.#.....#...#...#.......#.....#...#.#.....#...#.#.#.......#.
.#####.###.#######.#.#.#.###.#.#####.#.#.#.###.#.#.#.###.#####.#########.#.#.#######.#.#.###.###.#.
.....#...#.....#...#.#.#...#.#...#...#...#.#...#.#.#.#...#...#...#.......#.#.#.......#.....#...#.#.
####.###.#####.#.###.#.#####.###.#.###.###.#.###.#.#.#.###.#.###.#.#######.#.#####.#######.###.###.
.......#.....#.#.#...#.#.....#.#.#...#...#.#...#.#.#.#.#...#.....#.#.......#.....#.......#...#...#.
.###########.#.#.#.###.#.#####.#.###.#####.###.#.#.#.#.#.#########.#####.#.#####.#####.#####.###.#.
.#.........#...#.#...#...#.....#...#.......#...#.#.#.#.#.......#...#...#.#.#...#.....#.....#.#...#.
.#.#######.#.###.###.#####.#.#####.###.#####.###.#.#.#.#######.#.###.#.#.#.#.#######.#.###.#.#.###.
.#.#.#.....#.#...#.#.#.....#.#...#...#.#...#.....#.#.....#...#...#...#...#.#...#.....#...#.#.#...#.
.#.#.#.#######.###.#.###.#.###.#.###.###.#.#.#######.#####.#.###.#.#######.###.#.#########.#.###.#.
.#.#...........#...#...#.#.....#...#.....#.#.#.....#...#...#...#.#.#.#...#.....#.........#.#...#...
.#.#######.#####.#.###.###.#####.#########.###.###.###.#.#####.#.#.#.#.#.#####.#########.#.###.####
.#.#...#...#...#.#.......#.#.....#.......#.....#.#.#...#.#.....#...#...#.....#.#.......#.#.....#...
##.#.#.#####.#.#########.###.#####.#.###.#######.#.#####.#.#########.#####.#.#.#####.#.#.###.#####.
...#.#.......#.#.....#.......#.....#.#...#...#...#.#.....#.....#...#...#.#.#.#.....#.#.#...#.......
.#.#.#########.#.###.#########.#####.#.###.###.#.#.#.#########.###.###.#.#.#######.#.#.###.#######.
.#.#...#.#.....#...#...#.....#...#...#.....#...#...#.......#.....#.....#.#...........#.#...#.....#.
.#.###.#.#.#######.###.#.###.#.###.#######.#.#######.#####.#####.###.###.###############.###.#.###.
.#.#.#...#.....#...#.#.#...#...#...#.....#.#.......#.#...#...#.....#.......#.#.........#.#...#.#...
.#.#.###.#####.#.###.#.###.#####.###.###.#########.###.#.###.#####.#######.#.#.#######.#.#.#.#.#.##
.#.....#.#...#.#.#...#...#.#.#...#...#.#.......#.#...#.#...#.....#.......#.#.#.#.....#...#.#.#.#...
.###.###.###.#.#.#.#.#.###.#.#.###.###.#####.#.#.###.#.###.#####.#######.#.#.#.#.###.#######.#####.
.#...#.......#.....#.#...#.#.#...#.#.....#.#.#...#...#.#...#.....#.#.....#...#...#.#...#...#...#...
.#####.#####.###########.#.#.###.#.#.###.#.#.#####.###.#.###.#####.#.#######.#####.###.#.#.###.#.##
.......#...#...#.........#.#.#...#.#.#.#...#.#...#.#...#...#.#.....#...#.#.........#.#.#.#.....#.#.
.#######.#.###.#.#######.#.#.#.###.#.#.###.#.#.#.#.#.#.###.#.#.###.###.#.#.#######.#.#.#.###.###.#.
.#.....#.#...#.#.#.....#.#.#.#...#...#.....#...#...#.#.#.#.#.#...#...#.#...#...#.....#.#...#.#...#.
.#.###.#.###.#.#.#.###.#.#.#.###.#####.###############.#.#.#.#######.#.#####.#.#######.###.###.###.
.#.#.#.#.#...#.#.#...#.#.#.#...#.......#.........#.....#...#...#...#.#.#.....#.........#...#...#...
.#.#.#.#.#.###.#.#.#.###.#.#.#.###########.#####.#.#####.#####.#.#.#.#.#.###############.#.#.###.#.
...#...#.#.#...#.#.#.....#.#.#.....#.....#.....#...#...#.......#.#...#...#.......#...#...#.#.....#.
##.#####.#.#####.#.#######.#.#.###.###.#.#####.#####.#.#########.###########.#.#.###.#.#.#########.
.#.#.....#.....#.#...#.....#.#...#.....#.#...#.#.....#...#.#.....#.........#.#.#.....#.#.........#.
.#.#.#########.#.#.###.#####.###.#######.#.#.#.#.#######.#.#.#.#.#.#####.#.###.#####.#.#####.#####.
...#.#.....#...#.#.#...#...#...#...#...#...#...#.....#...#.#.#.#.#.....#.#.....#.....#.....#.#...#.
.###.#.#####.###.#.#.###.###.#####.#.###########.###.#.###.#.#.#.#####.#.#######.#########.#.#.#.#.
.#...#.....#...#.#.#...#.....#...#.#.........#.....#.#...#.#.#.#...#...#.....#.....#.....#.#...#.#.
.#.#####.#.###.#.#.###.#.#####.#.#.###.###.#.#.#####.###.#.#.#.###.#.#######.#####.#.#.###.#####.#.
.#.#...#.#.......#...#.#...#...#.#...#...#.#.#.#.....#.#...#.#...#.#...#...#...#.....#.#.....#...#.
.#.#.#.###.#######.###.#.###.###.###.###.#.###.#.#####.#.###.###.#####.#.#####.#.#######.#####.###.
.#...#...#.#...#...#...#.#...#.#...#...#.#.....#...#...#.#...#.#...#...#.....#.#.#.........#...#...
.#######.###.#.###.#.#####.###.###.#.#.#.#########.###.#.#.###.###.#.#####.###.#.#.#########.###.##
.....#.#.....#...#.#.....#.#.......#.#.#.....#...#...#...#.......#...#.....#...#.#.#.#.......#...#.
####.#.#########.#######.#.#.#########.#####.###.###.###########.#####.###.#.#####.#.#.#######.###.
S..............#...........#...........#...........#...................#...#.........#.............
