.#.....#...#.........#.....#.......#.......#.....#...#.............#...................#.....#....G
.#.###.#.#.#.#####.#.#.#####.#####.#.#####.#.#.###.#.#.#.#########.#############.#####.#.#.#.###.##
...#.#.#.#.#.#...#.#.#...........#.......#...#.....#...#...#.......#.......#.....#...#.#.#.#...#...
####.#.#.#.###.#.#.#.#############.#########.#####.#######.#.#######.#####.#.#######.#.#.#.###.#.#.
.#...#...#.#...#...#.............#.#.#.....#.#...#.......#.#.........#...#.#.#.......#.#.#.#...#.#.
.#.#.#####.#.###################.#.#.#.###.###.#.#####.###.###########.###.#.#####.###.###.#.###.#.
...#.....#...#.......#.......#...#...#.#.#.....#...#...#...#.......#.#.....#.....#...#.#...#...#.#.
.#######.#######.###.#.###.###.###.###.#.#########.#.###.###.#####.#.#.#########.#.#.#.#.#####.###.
.......#.........#...#.#.#.....#...#...#.....#.....#...#...#...#.#.#...#.........#.#...#.....#...#.
####.###.#########.###.#.#########.#.###.#####.#######.###.###.#.#.#.#######.#######.#######.###.#.
...#.#...#.......#.#.#.#...#.....#.#.#.#.......#...#.....#...#.#.#.#.......#...#...#.........#.#...
.#.#.#.###.#####.#.#.#.#.###.#.#.###.#.#.#######.#.#####.###.#.#.#.#######.###.#.#.###########.###.
.#.#.#...#.....#...#.#.#.....#.#.....#.#.#.......#.....#.#.#...#.#...#...#...#.#.#.#.....#...#...#.
##.#.###.#####.#####.#.#######.#######.#.###.#########.#.#.#####.###.###.###.#.#.#.#.###.#.###.#.#.
...#...#.#.....#...#.#...#...#...#.....#...#.#.....#...#.#.........#...#.#...#.#.#...#...#.....#...
.###.###.#.#####.#.#.###.#.#.#.#.#.#######.#.#####.#.###.#.#######.###.#.#.###.#.#####.###.########
.....#...#.#.....#.#...#...#.#.#.#.......#.#...#...#...#...#.......#...#.#...#.......#...#...#...#.
.#####.###.#.#####.#.#.#####.###.#####.#.#.###.#.#####.#####.#######.###.###.#####.#####.###.#.#.#.
.#.....#.....#...#...#.....#.....#.....#.#.....#.....#.#...........#.#.....#.....#.#.....#...#.#...
##.#####.#######.#########.#######.#################.#.#####.#######.#.###.#####.###.#####.###.###.
...#.....#.#...#.........#.....#...................#.#.....#.#.......#...#.....#.#...#.....#...#...
.###.#####.#.#.#.###.###.#####.###.#####.#########.#.#####.#.#.#######.#####.#.#.#.###.#######.#.##
.#.....#...#.#.#.#...#.......#...#.....#.#.......#...#...#.#.#.#.....#.#.....#.#...#...#.......#.#.
.#####.#.###.#.###.#############.#.#####.###.#.#####.#.#.#.###.###.#.#.#.#####.#####.###.#######.#.
...#.#...#...#...#.......#.....#.#.#...#...#.#.#...#...#.#.....#...#.#.#...#.......#...#.....#.#.#.
##.#.#.###.#####.#.#####.#.###.#.###.#.###.#.###.#.#####.#######.###.#.###.###.#######.#####.#.#.#.
...#...#...#.#...#.....#...#.#...#...#...#.#.....#.....#.#.......#...#...#...#.#.....#.......#...#.
.#######.###.#.###########.#.#####.#####.#.#########.###.#.#######.#####.###.###.#.###########.###.
.........#...#.....#.....#.#.......#.....#.#.........#...#...#.#...#...#.#.#.....#.........#.#...#.
.###########.#####.#.###.#.#####.###.#####.#.#######.#.#####.#.#.###.#.#.#.###########.###.#.###.#.
.......#.....#...#.#.#.#.#.#.....#.#.....#.#.......#.#.......#.....#.#...#.........#...#.#.....#.#.
######.#.###.###.#.#.#.#.#.#.#####.#####.#.#######.###########.#####.#############.#.###.#####.#.#.
.#.....#.#...#...#.....#.#.#.#.........#...#.....#.........#.....#...#.............#.#...#.....#.#.
.#.#####.###.#.#.#######.#.#.#.#.#.#########.###.#########.#.#####.###.###.#####.###.#.#.#.#####.#.
.#.#.#.....#...#.#.#.....#...#.#.#.#.......#...#.....#.....#.#.....#.....#.....#.#...#.#...#.#...#.
.#.#.#.###.#####.#.#.#########.#.###.###.###.#.#####.#.#####.#.#########.#####.#.#.#####.###.#.###.
.#.#.....#...#.....#.#.....#.#.#.....#.#...#.#.#...#...#.....#...#...#.......#.#.#.....#.....#.#...
.#.#####.###.#.#####.#.###.#.#.#######.###.#.#.#.#.#####.#######.#.#.#######.#.#######.#######.#.##
.#...#...#...#.#.#...#.#...#.#...#.#.....#...#...#.#.....#.....#...#.....#.#.#.#.....#.#.......#...
.###.#####.###.#.#.###.#.###.###.#.#.#.#.#########.#.#########.#########.#.#.#.#.###.#.#.#######.#.
...#.......#.#...#...#.#.#.......#...#.#...#.......#.................#...#...#.....#.#...#.....#.#.
.###########.###.###.#.#.#.###########.###.#.#####.#########.#######.#.#############.#####.###.###.
.............#...#.#...#.#...#.....#...#...#...#...........#.#.....#.#.#.........#.......#.#.#.#...
########.#####.###.#####.###.###.#.#.###.#####.#########.###.#.###.#.#.#.#######.#.#####.#.#.#.#.##
.........#.....#.....#...#.#.....#...#.#.#...#...#...#...#...#.#...#.#...#.....#...#...#...#.#.#...
.#######.#.#########.#.###.###########.#.#.#.###.#.#.#####.###.#.#########.###########.#####.#.###.
...#...#.#...#.....#.#...#.........#...#.#.#...#...#.#.....#...#.#.......................#...#...#.
.#.#.###.###.###.#.#.###.#.###.###.###.#.#.#########.#.#####.###.#.###############.#####.#.#####.#.
.#.#.......#.....#...#.#.#...#...#.#...#.#.........#.#.#.....#.#...#.#.............#...#.#.....#.#.
.#.#.###############.#.#.###.###.#.#.###.###.###.###.#.#.#####.#####.#.#############.#.#.#####.#.#.
.#.#.#.........#.....#.#.#...#...#.#...#...#.#.#...#...#.....#...#...#.#.#...#...#...#.#.#.....#.#.
.#.###.#######.#.#####.#.#####.###.###.###.#.#.###.#########.#.#.#.###.#.#.#.#.#.#.###.#.#.###.#.#.
.#...........#.#.....#.#...#...#.#.......#.#.....#.........#...#...#...#.#.#...#.#.#.#.#...#.#.#...
.#############.#####.#.###.#.###.###.#####.#####.#########.###.#####.###.#.#####.#.#.#.#####.#.###.
.....#.........#.........#.#.#.......#.....#...#.#.......#...#.#.....#.....#...#...#.#...........#.
######.#####.###.#########.#.#####.###.#####.#.#.#.#####.#.###.#.#####.#####.#.#####.#############.
.......#...#.#...#...#.....#.#...#...#.#.....#.#.#.....#.#...#.#.....#.#.....#...#.....#.#.....#...
.#######.###.#.###.#.#.#####.#.#.#####.#.###.#.#######.#.###.#.#####.#.###.#.###.###.#.#.#.###.#.##
.#...#.......#...#.#.#.....#...#.......#.#.#.#.....#...#.....#.#.....#...#.#.#.#.....#.#...#.#.#.#.
.###.#.#########.#.#.#####.#.###########.#.#.#####.#.#######.#.#.#######.###.#.#######.###.#.#.#.#.
...#...#...#...#...#.#...#.#.....#.........#.#...#...#.....#.#.#...#...#...#.#.....#.#...#...#.#...
##.#.###.#.#.#.#####.#.#.#.#####.#########.#.#.#.#######.#.#.#.###.#.#.###.#.#.#.#.#.###.#####.###.
...#.#...#...#.#.#...#.#...#...#...#.....#.#...#.......#.#...#...#.#.#...#...#.#.#...#...#.....#...
.###.#.#######.#.#.###.#####.#####.#.###.#############.#####.###.#.###.#.#######.###.#.###.###.#.##
.#.#...#.....#...#...#.#.....#...#...#.#.....#.........#...#.#...#...#.#.........#...#...#.#...#...
.#.#.###.###.#.#####.#.###.###.#.#####.#####.#.#########.#.#.#.#####.#########.#.#######.#.#.#####.
.#.#.#...#.#.#.#...#.#.#...#...#...#.....#...#.#.........#.#.#.#...#.........#.#.#.....#.#.#.....#.
.#.#.#.###.#.###.#.#.#.#.###.#####.#.#.###.###.#.#########.#.#.#.#.#########.#.#.#.#.###.#.#######.
.#...#.#...#.....#...#.#...#...#.#...#.#...#...#.#.......#.#.#...#.....#.#...#.#.#.#.#...#.....#...
.#.###.#.#############.###.###.#.#####.#.###.#.#.#####.#.#.###########.#.#.###.#.#.#.#.###.###.#.##
.#.#...#.#...........#...#...#...#.....#...#.#.#...#...#.#...............#.#...#.#.#...#.....#.#.#.
.###.###.#.#########.#.#.###.###.#.#######.###.###.#.###.#################.#.#.###.###########.#.#.
...#.#...#...#...#.#.#.#...#.....#.#.......#.....#.#.#...#...........#.....#.#.....#.......#...#...
##.#.#.#####.#.#.#.#.#.###.#.#####.#.#######.#####.#.#.###.#########.#.#.#########.#.#####.#.#####.
...#.#.....#.#.#...#.#...#.#.#...#.#.#.......#.....#.#.#...#.#...#...#.#.#.......#.#...#.....#...#.
.#.#.###.###.#.###.#.###.#.#.#.#.#.#.#.###.###.#####.###.###.#.#.#.###.###.#####.#.###.#####.#.#.#.
.#.#...#.#...#...#.#...#.#.#...#.#...#.#.#.#...#.....#...#.....#.#.....#...#.#...#.....#...#.#.#...
.#####.#.#.###.#.#####.###.###.#####.#.#.#.#.#####.###.#########.#####.#.###.#.#########.#.###.####
...#...#.#...#.#.........#...#.#...#...#...#.#.....#...#.............#.#.....#...........#...#.....
.#.#.###.###.###.#######.###.###.#.#####.###.#.#.#.#.#####.#########.#.#####.###############.#####.
.#.#.#.....#...#.#.....#...#.#...#...#...#...#.#.#.#.#...#.......#...#.#...#...#...........#.....#.
##.#.#.###.###.###.###.###.#.#.#####.#.###.#####.#.#.#.#.#####.#.#####.#.#####.#.#.###.#######.#.#.
...#.#...#...#.......#.#.#...#.#.....#...#.....#.#.#...#.#...#.#.....#...#...#.#.#.#...#.....#.#.#.
.###.#####.###########.#.#.###.#.#######.#####.#.#.#####.#.#.###.###.###.#.#.#.#.#.###.#.###.#.###.
...#.....#.......#.....#...#...#.....#.......#.#.#.#...#...#...#.#...#...#.#...#.#...#.#.#.....#...
.#.#####.###.###.#.###.#####.#######.#.#######.#.#.#.#.#######.#.#.###.###.#####.###.###.###.###.##
.#...#.#...#...#.#...#.#...........#.#.#...#...#.#...#.....#...#.#.....#.#.#.......#...#...#.#...#.
##.#.#.###.###.#.###.#.#.###########.###.#.#.###.#######.###.###.#######.#.#.#########.###.###.###.
...#.....#...#.#...#.#.#.....#.......#...#...#...#...#...#...#.#...#.....#.#.#...........#.....#...
.#######.###.#####.#.#.#####.#.#######.#######.###.#.#.###.###.###.#.###.#.###.#########.#########.
.....#.#...#...#...#.#.#.....#.....#...#...#.......#.#.#...#.......#.#...#...#.....#...#...#.......
.###.#.###.###.#.###.###.#########.#.###.#.#######.#.#.#.#####.#######.#.###.#####.#.#####.#.######
...#.#.....#...#...#...#.........#...#...#.......#.#.#.#.....#.#.......#...#.......#.....#.#.......
##.#.#######.#####.###.#########.#######.#######.#.#.#######.#.###.#.#################.###.#######.
...#.#.....#...#.....#.....#...#.#.......#.#.....#.#.#...#...#.....#.#.......#.........#...#.....#.
.###.#.###.###.#.#######.#.#.#.#.#####.###.#.#####.#.#.#.#.#########.#.###.###.#####.###.###.###.#.
.#...#...#...#.#.......#.#.#.#.#.......#...#...#...#...#.#.#.........#...#...#.#...#...#...#...#.#.
.#.#####.###.#.#######.#.###.#.#########.#####.#########.#.#############.###.#.###.###.###.###.#.#.
S#.........#...........#.....#...........................#.................#.........#.........#...