.......#.......#...........#..........G
.#.###.#####.#.#.#.#########.#########.
.#.#.........#...#.#...............#...
##.###############.#.###############.#.
...#...#.......#...#.#...#.#.........#.
.###.#.#.#####.#####.#.#.#.#.#########.
.#...#.#...#...#...#.#.#...#.#.........
.#.###.###.#.###.#.#.#.#####.###.######
.#...#.....#.....#.#...#...#...#.......
.###.#############.#.###.#.###.#######.
...#.#...........#...#...#.....#...#...
.###.###.#.#.#########.###########.#.##
...#...#.#.#.#.....#...#.....#.....#...
.#.###.###.#.#.###.#.###.#####.#.#####.
.#...#.#...#.#.#...#.#...#.....#.......
.#.#.#.#.###.#.#.#.#.###.#.############
.#.#.#.#...#.#.#.#.#...#...#...........
##.#.#.#.#.###.#.#####.#.###########.##
...#.#.#.#.#...#...#...#...#.......#...
.#####.#.#.#.#####.#.#####.#.#####.###.
...#...#.#...#.....#...#.....#.....#...
##.#.#####.###.#######.#.#####.#####.#.
...#.....#...#.......#.#.#...#.......#.
.#######.###.#####.###.#.#.#.##########
.#.....#.#...#...#...#.#.#.#.....#.....
.#.#.###.#.###.#.###.#.#.#.#####.#.###.
.#.#...#.#.....#...#.#.#.#.....#.....#.
.#.###.#.###########.#.#######.#######.
.#.#.#...#.........#.#.......#.#...#...
.#.#.#####.#######.#.#######.#.###.#.#.
.#...#.....#.#.....#...#.#...#.#...#.#.
.###.###.###.#.#####.#.#.#.###.#.###.#.
.........#...#.#.....#...#.....#.#...#.
.###########.#.#.#.#####.#######.#.###.
.#.....#.....#.#.#...#...........#...#.
.#.###.###.###.#####.#.#############.#.
.#.#.#...#...........#.#.....#.......#.
##.#.###.###############.###.#.#######.
S..#.....................#.....#.......