.#.............#.............#.....#.......#.....#.....#..G
.#####.#########.###.#######.#.#.#.#.#####.#.###.#.###.###.
.#...#.#.........#.#.#...#...#.#.#...#...#.#...#...#.......
.#.#.#.#.#########.#.###.#.###.#.#######.#.###.#.#########.
...#.#.#.....#.....#.#...#...#.#.#.....#.#.....#.#.......#.
####.#.#####.#.#.###.#.#####.###.#.###.#.#####.###.#####.#.
...#.#.....#.#.#...#.#.....#...#...#...#.......#...#...#.#.
.#.#.#.#####.#####.#.#.#.#.###.#####.###.#####.#.###.###.#.
.#...#.............#.#.#.#...#...#...#...#...#.#...#...#.#.
.#######.###########.###.#.#####.#.#######.#.#.###.###.#.##
.#.....#.#.........#.#...#.#...#.#.#.......#.#...#.....#...
.#.###.###.#######.#.#.#####.#.#.#.#.#######.#########.###.
.#.#.#.....#.....#.#.#.......#...#.#.#.....#.#...........#.
.#.#.###########.#.#.#####.#######.#.###.###.#.###########.
.#.#.............#.#.....#.......#.#...#.#...#.#...#.....#.
.#.###.#########.#.###.#.#######.#.###.#.#.###.#.#.#.###.#.
.#...#...#.....#.#...#.#...#.....#...#...#.....#.#.#.#.#.#.
.###.#.#.#.#####.###.#.###.#.#####.#.###.#########.#.#.#.#.
.#...#.#.#.#.....#...#.#...#.#...#.#.....#.........#.#.#.#.
.#.###.#.#.#.#####.###.#.###.#.#.#.#######.#####.#.#.#.#.#.
...#...#.#.#.#...#.#...#.#...#.#.......#...#.....#.#.#...#.
########.#.#.###.#.#####.#.#####.#####.###.#.#######.#.###.
.....#...#.......#.......#.....#.#...#...#.#.......#.#.#...
.###.#.#########.#############.#.#.#.###.#########.#.#.#.#.
...#...#...#...#.............#.#.#.#.#.......#...#.#.#.#.#.
##.#.###.#.#.#.###.###########.###.#.#######.#.#.#.#.#.#.#.
...#.#...#.#.#.....#.....#...#.....#.......#...#...#.#...#.
.###.#.###.#.#######.###.#.#.#############.#####.###.#####.
.#...#.#.#.#.#.....#...#...#...#...#.......#...#.#...#.....
.#.###.#.#.###.###.###.#####.#.#.#.#.#######.#.#.#.###.####
.#...#...#...#...#.#...#...#.#...#.#.#.......#.#.#...#.#...
.#.#####.###.#.###.#.###.#.#.#.#####.#.###.###.#####.#.###.
.#.#.....#.#...#...#.#...#.#.#.#.....#...#.#.#.#.....#...#.
.#.#.#####.#####.###.###.###.#.#.#####.###.#.#.#.#######.#.
.#.#...#.....#.#...#...#...#.#.#.#.#...#...#.#.#...#...#.#.
.#####.#.###.#.###.###.###.#.###.#.#.###.###.#.###.#.###.#.
.#...#...#.#...#.#...#.....#.....#.....#...#.#.#...#...#.#.
.#.#.#####.###.#.###.#####.###############.#.#.#.###.#.#.#.
S..#...............#.......................#.....#...#.....