.....#...........#.......#.........#..G
.###.#.#####.###.#.#.###.#.#######.#.##
.#...#...#.#.#...#.#.#.....#...#...#...
##.#.###.#.#.###.###.#######.#.#.#####.
...#.#.....#...#...#.........#.#.......
.###.#.#####.#.###.#####.#####.#######.
...#.#.#...#.#...#.....#...#...#.......
##.###.#.#.#####.#####.#####.###.######
...#...#.#.....#.#...#.....#...#.#.....
.###.###.#####.#.#.#.#####.###.#.#####.
.#...#.#.#...#.#.#.#...........#.......
.#.###.#.#.#.#.#.#.####################
.......#.#.#.....#.#.........#.....#...
.#######.###########.#######.#.###.#.#.
.#...#...#...........#.....#...#.#...#.
##.#.#.###.#############.#.#####.#####.
...#.#.....#.....#.......#.#...#.....#.
.###.#.#######.#.#.#######.#.#.###.#.#.
.#...#...#.....#...#.........#.....#.#.
.#.#####.#.#######.###############.###.
.#.....#...#.......#.....#.....#...#...
.#####.###.#########.###.#.###.###.#.#.
...#.#...#.#.......#.#.#...#.#...#.#.#.
##.#.###.###.#####.#.#.#####.###.#.#.##
...#.......#.#...#...#...#.....#.#.#...
.#########.#.#.#.#####.#.#.###.#.###.#.
.........#.#...#.#.....#.#.#.#.#...#.#.
.#######.#.#####.#.#######.#.#.###.###.
...#...#.#.......#.......#...#...#...#.
##.#.#.#.#########.#####.###.###.###.#.
...#.#.#.......#.#.....#...#.#.#.#...#.
.###.#####.###.#.#####.###.#.#.#.#.###.
.#...#...#...#.#.....#...#...#.#...#...
.#.###.#.#####.#.#.#.###.#####.#####.##
...#...#.......#.#.#...#.....#...#.....
####.###########.#.###.#####.#.###.###.
...#.#.......#...#...#.#...#.#.......#.
.#.#.#.#######.#####.###.#.#.#########.
S#...#.............#.....#.............