....#....G
.##...####
.##.######
.#...#####
##.####.##
...###S.##
.######.##
.######.##
....##..##
.##....###