.....#.......#...#...........#.......#...............#.......#.......G
####.###.###.#.#.###########.#.#####.#.###########.#.###.#.#.#######.#.#.#.#.#.#.#.#.#####.###.#####.###.#.###.#.#########.#.#.#.#####.#.##
...#.#...#...#.#.....#...#...#...#...#.#.....#.....#...#.#.#.........#...#.#.#.#.#...#...#.#.#.#...#...#.#...#.#.#...#...#.#...#.......#...
.###.#.###.###.#####.#.#.#.#.###.#.###.#.#.###.#######.###.###############.#.#.#.#######.#.#.#.#.#.#####.###.#.###.#.#.#.#.#########.#####.
...#.#.#.......#.......#...#.#...#.......#.#...#.......#...#...#.........#.#.#.....#.....#.#...#.#.......#...#.#...#.#.#.#.........#.#.....
##.#.#.#######.#############.#.###########.#.###.#######.###.#.#.#######.#.#.#####.###.###.#.###.#########.###.#.###.#.###########.###.###.
...#.#.......#.#.........#...#.#.#.......#.#.#...#.....#...#.#.#.....#...#.#.#...#.....#...#...#.#.......#.#.....#.#.#...........#.#...#...
.###.#.#####.###.#######.#####.#.#.#####.###.#.###.#####.#.###.#.#####.#.#.###.#.#####.#.#####.#.#.#####.#.#.#####.#.#####.#.#####.#.######
.#...#.#...#.........#.#.#.......#.#.....#...#.#.........#...#.#.#.....#.#...#.#...#...#...#.#.#.#.....#...#...#...#...#...#.#...#.#...#...
.#.###.#.#.#########.#.#.#.#######.#.#####.###.###.#########.#.#.#.#####.###.#.###.###.###.#.#.#.#####.#######.###.###.#.###.#.#.#.#.#.#.#.
.#.#...#.#.#.....#.....#.....#.....#...#...#.#...#.........#.#.#.#...#.#...#.#...#...#.#...#...#.#.....#.#...........#.#.#...#.#...#.#.#.#.
.#.#####.#.#.###.#######.#####.#######.#.###.###.#.#########.#.#.###.#.###.#.#.#.###.#.#.#####.#.#####.#.#.#####.#####.#.#####.#####.#.#.#.
.#.......#...#.#...#...#.#.....#.....#.#.#.....#.#.#.........#.#...#.#.....#.#.#...#.#.#.....#...#...#.#...#...#.#.....#...#...#...#.#...#.
.#############.###.#.#.#.#.#####.#.###.#.#####.#.###.#########.###.#.#.#####.#.###.#.###.###.#####.#.#.#####.#.#.#.#####.#.#.###.###.#####.
.#...#.......#.....#.#.#.#...#.#.#.#...#.....#.#...#.#.........#...#.#.....#.#.#.#.#...#...#.......#.#.#...#.#.#.#...#...#.#.#...#...#...#.
.#.#.#.#####.#.#####.#.###.#.#.#.#.#.#######.#.###.#.###.###.###.###.#######.#.#.#.###.#############.#.#.#.#.#.###.#.###.#.#.#.#.#.###.#.#.
...#.#...#.#.#...#...#...#.#.#...#.#.#.....#.#...#...#...#...#...#.#.......#.#...#.#...#...........#.#...#...#...#.#...#.#...#.#.....#.#...
.###.###.#.#.###.#.#####.###.#.###.#.#.###.#.###.#####.###.###.###.#######.#.#####.#.###.#########.#.#.#########.#####.#.###########.#.###.
.#...#.....#...#.#.....#...#.#...#.#.#.#.#.#.#.......#...#.#...#.....#...#.#.#.....#.....#.#.......#.#.#.....#.......#.#.........#...#.#...
.#.###.#####.#.#.#####.###.#.#####.#.#.#.#.#.#.#######.#.###.#####.###.#.#.#.#.###########.#.#######.###.###.#######.#.#########.#.###.####
.#.....#...#.#.#.......#.#.#.#...#.....#.#...#.......#.#...#.#...#...#.#...#...#.....#.....#.......#.#...#...#...#.....#.......#.#.#.#.....
.#######.#.###.#########.#.#.#.#.#######.###########.#.###.#.#.#.#.#.#.#########.#####.###.#######.#.#.###.###.#.#######.#######.#.#.#####.
.......#.#.........#.....#.#...#...#.......#.........#...#.#.#.#.#.#.#.........#.........#.#.......#...#...#...#...#.............#.......#.
########.#########.#.###.#.#.#####.#.###.#.#.###########.#.#.#.#.###.#########.#.#########.#.#########.#.###.#####.#.###########.#########.
.........#.....#...#...#.#.#...#...#.#...#...#...........#.#...#...#...#.....#.#.....#...#.#.........#.#...#.#...#.#.#...#.#...#.......#...
.#########.#.###.###.#.#.#.#####.#####.###.###.###########.#######.#.#.#.###.#.#####.#.#.#.#########.#####.#.#.###.#.#.#.#.#.#.#######.#.##
.#.........#.....#...#.#.#.#...#.....#.#...#...#...#.........#...#.#.#.#...#.......#.#.#.....#.....#.....#.....#...#...#...#.#.#...#.#.#...
.###############.#####.#.#.#.#.#.###.#.###.#.###.###.#######.###.#.#.#.###.#########.#.#######.###.#####.#######.###########.#.#.#.#.#.###.
...............#.......#.#...#.#...#.#...#.#...#...#...#...#.#...#.#.#...#...........#.......#.#.....#.#.....#...#...........#...#.#.#.....
.#############.###############.###.#.#.#.#.###.###.###.#.#.#.#.###.#.###.###################.#.#.###.#.#####.#.###.#########.#####.#.#####.
.......#.....#.#.......#.....#...#.#.#.#.#...#.#.....#.#.#.#...#...#...#.....#.............#...#...#.......#.#.........#...#.#.....#.....#.
######.#.#####.#.#####.#.###.###.#.#.#.#.#####.#.#####.#.#.###.#.###########.#.#####.#####.#######.#######.#.###########.#.###.#####.#####.
...#...#.....#.#.#.#...#...#.#...#.#.#.#...#...#...#...#.#.....#.#.........#.......#.....#.....#.#.....#...#.#...........#...#.#.#.........
.###.#######.#.#.#.#.#####.#.#.#####.#.###.#.#####.#.###########.###.#####.#############.#####.#.#####.#####.#.#############.#.#.#.########
S............#.....#.......#.........#...#.........#.................#...................#...........#.........#...............#...........
