...#...#.....#....G
##.#.#.#.###.#.###.
.#...#.#.#...#...#.
.#####.#.#.#####.#.
.....#...#.#.....#.
.#########.#.#####.
.#.......#...#...#.
.#.###.#########.#.
...#...#.........#.
.###.###.###.###.#.
...#...#...#...#.#.
##.###.###.###.###.
.#.#.#...#...#.....
.#.#.###.###.######
...#...#...#.#.....
.#####.###.#.#.###.
.#.......#...#...#.
.#.#####.#########.
S..#...............
