.................#.......#.....#.........#.#...........#.......#.......#...#..G
.###.###########.###.#.#.#.###.#.#.#####.#.#.#######.#.#.###.#.#.#####.#.#.###.
.#.#...........#...#.#.#...#.#.#.#.#...#...#...#.#...#.#.#.#.#...#.#...#.#...#.
.#.###########.###.###.#####.#.#.###.#.###.###.#.#.###.#.#.#.#####.#.###.###.#.
.........#...#.#.#...#...#.#...#...#.#...#...#.#.#.#...#...#.#.....#.....#...#.
########.#.###.#.###.###.#.#.###.#.#.###.#####.#.#.#####.###.#.###.#######.###.
.#.....#...#...#...#...#.#.....#.#.#.#...#.....#.#...#...#...#.#.........#...#.
.#.###.#.###.###.#.###.#.#####.###.#.#.###.#####.###.#.###.###.#####.#######.#.
.#...#...#...#...#...#.#.....#...#...#...#.........#...#...#.......#.#.....#.#.
.###.#####.#####.###.#.#.###.###.#######.#########.#####.###.#####.###.###.#.#.
.........#.#.....#...#.#.#...#...........#.....#...#...#...#...#...#...#.#.#...
##########.###.#######.###.#.#####.#####.#.###.#.###.#####.#####.#.#.###.#.###.
.........#...#.........#...#.#...#.#...#.#.#...#.#...#.....#.....#.#...#.#...#.
.#######.###.#.#########.#####.#.###.#.#.#.#.###.###.#.#####.###.#####.#.###.#.
.#.....#...#.#...#.............#.....#.#...#.#.......#...#...#...#...#.#...#...
.#.###.###.#.###.#######.#############.#.#####.#######.#.###.#####.#.#.#.#.####
...#.#...#.#.#.#...#...#.....#...#.....#.#...#.#.....#.#...#.#.....#.....#.#...
.###.###.#.#.#.###.#.#.#####.#.#.#.#####.#.#.#.#.###.#.###.#.#.###########.###.
.....#.#.#...#.......#...#.....#.#.#.....#.#...#.#.#.#.#.#.#...#.....#.........
####.#.#.###############.#########.#.#####.#####.#.#.#.#.#.###.#.###.#########.
...#.#.#.........#...#...#...#.....#.#...#.#...#.#...#...#...#.#.#.#.#.....#...
.#.#.#.#########.#.#.#.###.#.#.#####.#.#.#.#.#.#.#.#########.#.#.#.#.#.###.###.
.#.#.#.....#...#.#.#.#.#...#.#.....#...#.#.#.#...#...........#.#...#...#.#...#.
.###.#.#.#.#.###.#.#.#.#.###.#.###.#######.#.#######.#############.#####.###.##
...#.#.#.#...#...#.#.#.#...#.#...#.........#...#...#.#...#.........#...#...#...
.#.#.###.#####.###.###.#.#.#.###.#############.###.#.#.#.#.#########.#.###.###.
.#.......#...#.#.#.....#.#.#...#...#...#.....#...#...#.#.#.......#...#.#...#...
.#########.#.#.#.#.#####.#.###.#####.#.#.###.###.#####.#.#######.#.###.#.###.#.
.....#.....#...#.#.#.#...#.#.........#...#.#...#...#...#.......#...#.#...#...#.
##.###.#########.#.#.#.###.###############.###.#.#.#.#####.#########.###.#.####
.#.#...#...#.....#.#.....#.........#.........#.#.#.#.#...#.....#.........#.....
.#.#.###.#.#.###.#.###.#####.#####.###.#.#####.###.#.#.#.#####.#.#############.
...#.#...#.#...#.#...#.#...#...#...#...#.#.........#...#.#.....#...#.........#.
.###.#.#.#####.#.###.###.#.#####.###.#####.#############.#.#######.#########.#.
.#.#.#.#.#...#.#...#.....#...#...#.....#...#.#.........#.#.......#.....#.....#.
.#.#.###.#.#.#.#.###########.#.#####.#.#.###.#.###.###.#.#######.#####.#.#.###.
...#...#...#...#.........#...#.....#.#.......#.#.#.#...#...#.........#...#.#...
######.#.#############.###.#######.###.#######.#.#.###.###.#.#############.#.##
.......#.#.....#.....#.....#.....#...#...#.....#.#...#...#.#.#...#.........#...
.#######.#.###.#.#############.#.###.###.#.#####.###.###.#.#.#.#.#.###########.
.......#.#...#...#.............#.....#...#.#.....#.#...#.#.#...#.#...........#.
.#####.#.###.#####.#######.###########.###.#.###.#.###.###.#####.#####.#######.
.....#.#...#.#.......#...#.....#.#...#...#.#...#.....#.....#.#...#.#...#.....#.
######.###.#.#.#######.#.#####.#.#.#.###.#.###.#####.#######.#.#.#.#.###.###.#.
...#...#.#.#...#.......#.#...#.#...#...#.#.....#...#.#.......#.#...#.#...#...#.
.#.#.###.#.#####.#######.#.#.#.#.###.###.#########.#.#######.#.#####.#.###.###.
.#...#...#.......#.....#.#.#...#...#.......#.......#...#.....#.......#.#.#.#...
.#####.###########.###.#.#.#######.#######.#.#.#######.#.#.#####.#####.#.#.###.
.#...............#.#.#...#.......#.#...#.....#.#.....#...#.#...#.....#.#...#...
.#######.#######.#.#.###########.###.#.#########.###.#####.#.#.#######.#.###.##
...#...#...#...#.#...........#...#...#...........#.#...#...#.#.....#...#.#.....
.#.#.#.###.#.#.#############.#.###.#####.#########.###.#.###.#####.#.###.#####.
.#...#...#.#.#.......#.......#.....#...#.#.....#.....#.....#.#...#...#...#.....
########.#.#.###.#####.#######.#####.#.#.#.#.#.###.#.#######.###.#####.###.###.
...#.....#.#.#.#.....#...#...#.....#.#.#.#.#.#.....#...#...#...#.#...#.#...#...
.#.#.#####.#.#.#####.###.#.###.#####.#.#.###.#.#########.#.#.#.#.#.#.#.#.#####.
.#...#...#...#...#...#...#.#...#.....#.#.....#.#.........#.#.#.#...#...#.....#.
.#######.#.###.#.#.###.###.#.###.#####.#####.###.#########.#.#.###.#####.###.#.
...#.....#.....#.#.#...#.....#...#.....#...#.#...#.......#.#.#...#.#.....#...#.
##.#.#.#.#######.#.#.###.#####.###.#####.#.###.###.#####.#.###.#.#.#.#####.###.
...#.#.#.....#...#.#.#...#.....#...#.....#...#.#.....#...#...#.#.#.#...#...#...
.#####.#######.###.#.#####.#####.###.###.###.#.#####.#.#####.###.#.#####.###.##
.....#...........#.#.......#...#.#...#...#.#.#.....#.#.....#.....#.#.....#.#...
####.#.###########.#########.###.#.###.###.#.#.###.#.#####.#######.#.#####.###.
.....#...#.......#...........#...#...#.#.#...#...#.#...#.........#...#...#.....
.#########.#####.#.#####.#####.#####.#.#.#.#######.###.#.#######.#####.#.#.####
...........#...#.#.#...#.#.....#.....#.#...#.....#...#.#...#...#.#.....#.#.#...
.###########.#.#.#.#.#.#.#.#######.###.#.###.###.#.#.#.###.#.#.###.#####.#.###.
.....#.....#.#...#.#.#...#.......#...#.#.....#.#.#.#.#...#.#.#.....#...#...#...
####.#.###.#.#####.#.###.#######.#####.#######.#.###.###.#.#.#######.#######.#.
.#...#.#.....#...#.#.#...#.....#.#.....#.#.....#...#.#...#.#.#.#.....#.......#.
.#.###.#.#####.###.#.#.###.#.#.#.#.#####.#.###.###.#.#.###.#.#.#.###.#.###.###.
.#...#.#.#...#.....#.#.#.#.#.#.#.#.#.....#.#.....#...#...#...#.....#.....#.#...
.###.#.###.#.###.###.#.#.#.#.###.#.#.#.#.#.#.###########.#################.#.##
.....#.....#...#...#.#...#.#...#...#.#.#.#.#...........#.#...........#...#.#...
####.#####.###.#.###.###.#.###.#######.###.#####.#.#####.#.#########.#.#.#.###.
...#.#...#...#.#.#...#...#.#.#...#.....#...#...#.#.#...#.#.#.......#.#.#.#.#...
.#.###.#.#####.#.#.#######.#.###.#.#.###.###.#.#.###.#.#.#.#.#######.#.#.#.#.##
S#.....#.......#.#.............#...#.........#.#.....#.....#...........#...#...