.#.........#...#...............#...........#.....#........G
.###.#####.#.###.#.###########.#.###.#####.###.#.#.#.#####.
...#.#.....#.....#.#.........#.#.#...#...#.....#.#.#.#...#.
##.#.###.#########.#.###.#####.###.#####.#######.#.#.#.#.#.
...#...#.#.........#...#.#...#...#.#.......#.....#.#.#.#...
.#####.#.#.#########.#.###.#.###.#.###.###.#.#######.#.####
.#.....#...#.....#...#...#.#...#.#...#.#...#...#.....#.....
.#.#############.#.#####.#.#.#.#.###.#.###.###.#.#########.
...#...#.........#.....#...#.#.#...#.#...#...#...#.#.......
####.###.#.###########.#####.#####.#.###.###.#####.#.######
.#.......#.....#.....#.#...#.....#.#...#.#...#.....#.....#.
.#.###########.#.###.#.#.#######.#.###.#.#.###.#########.#.
.#.#.........#...#.#.#.#.#.....#...#...#.#.#...#.......#...
.#.#.###.###.#####.#.#.#.#.#.#######.###.#.#.#.#.###.#####.
...#.#...#.#.....#.#...#...#...........#.#...#.#.#.#.#...#.
.#####.###.#####.#.###############.###.#.#####.#.#.#.#.#.#.
.......#.....#...#...............#.#...#.#...#.#.#.#...#.#.
########.###.#.#####.###########.###.###.#.#.###.#.#####.#.
.#.......#...#...#...#.....#...#.#...#...#.#.........#...#.
.#.#######.#####.#.#.#.###.###.#.#.###.#.#.###########.###.
...#...#.#...#...#.#.#.#.#...#.#.#.#...#.#.....#.....#.#...
.###.#.#.###.#.###.###.#.###.#.#.#.#.#.#####.###.###.#.#.##
.....#.#.#...#...#.......#...#.#.#.#.#.#.....#...#.....#.#.
######.#.#.#####.#########.###.#.#.#.#.#.#####.#########.#.
.#...#...#.......#.....#...#...#.#.#.#.#...#...#.....#...#.
.#.#.###.#########.###.#.###.#.#.#.#.#####.#.#.#.###.#.###.
...#...#.#...#.....#.#.#...#.#.#...#.......#.#.#...#.#.....
.#####.#.#.#.###.###.#.###.#.#######.#######.#####.#.#####.
.....#.#...#.....#...#.#...#.......#.....#.#.....#.#.......
####.#.#############.#.#.###.#####.#####.#.#####.#.########
.....#...#.........#.#.#.#...#...#.....#...#...#...#.....#.
.#####.###.#####.#.#.#.#.#.###.#.#####.###.###.#######.#.#.
.#...#...#...#.#.#...#...#.#...#.#.......#...#.........#...
.#.#####.###.#.#.#########.#.###.#.#########.###.#########.
.#.....#.....#.#.......#.....#...#.#.......#.....#...#.....
.#####.#######.#######.#.#########.#.###.#########.###.####
.#...#...............#.#.#.........#.#.#.......#.....#...#.
.#.#.###############.#.#.#.#########.#.#######.#.###.###.#.
S..#.................#...#...................#.....#.......