.......#.#.....#.......#.....#.........#..................G
####.#.#.#.#.###.#.#####.###.#.###.###.#############.#####.
.....#...#.#...#.#.....#...#...#.#...#.......#...#...#...#.
.#########.###.#.#####.###.#####.###.#######.#.#.#.###.###.
.#.......#.#.#.#.....#...#.#.......#.......#.#.#...#.......
.#.#####.#.#.#.#.#######.#.###.###.#######.#.#.############
.#.#...#.#...#...#.......#...#...#.#...#.#.#.#.............
.#.#.#.#.###.#####.#####.###.###.#.#.#.#.#.#.###.#########.
...#.#.#.#.......#.#.#.....#.....#...#...#.#...#...#.....#.
.###.#.#.#.#######.#.#.#############.#####.###.#####.###.#.
.#...#.#...#.#.....#.....#...#.....#.#.....#.#.#.....#...#.
.#.#.#.#####.#.#####.#####.#.#.#.###.#.#####.#.#.#####.###.
.#.#.#.#.....#...#.....#...#...#.....#.#.#...#...#...#.#...
.###.#.#.#######.#####.#.#############.#.#.#.#####.#.#.#.##
.#...#.#.#.....#...#.#.#...#.....#.....#...#.#.....#.#.#...
.#.###.#.#.###.###.#.#.###.#.###.#.###.#####.#.#####.#.###.
.#.#.....#.#.....#.#...#...#...#.#.#...#...#.....#...#.#...
.#.#######.#.###.#.#####.#####.#.#.#####.#.#####.#.###.#.##
.#.......#.#...#.#...#...#...#.#.#.......#.....#.#.....#...
.#.#####.#.###.#####.#.###.#.###.#############.#####.###.#.
.#.....#.....#.#...#.#.#...#...#...........#.#.#...#.#...#.
.#####.#######.#.#.#.#.#.#####.#####.#####.#.#.#.#.#.#####.
.....#...#.....#.#.#.....#.....#.....#...#...#.#.#.#.......
####.###.#.#####.#.#######.#####.#####.#####.#.#.#.#######.
...#...#.#.#.....#...#.....#.....#...#.....#.#...#.#.....#.
.#.###.###.#.#######.#####.###.###.#.#####.#.#####.#.###.##
.#...#.....#.#.....#.....#.....#...#.......#...#.#...#.#...
##.#######.#.#.###.#####.#######.#####.#######.#.#####.###.
...#.......#.#.#...#...#.#.....#.....#.#...#...#.........#.
.###.#######.#.#.###.#.#.#.#.###.###.###.#.#.#########.###.
.....#.....#.#.#.#...#...#.#.......#.....#.....#...#...#...
######.###.#.#.#.#######.#####################.#.#.#.#.#.#.
...#...#...#...#.......#.#.........#...#.....#.#.#...#.#.#.
.#.#.###.#############.#.#.#######.#.#.#.###.#.#.#######.#.
.#.#...#.#...#...#.....#.#.....#.#...#...#.#.#.#.#.......#.
.#.###.#.#.#.#.#.#.#####.###.#.#.#########.#.#.#.#.#######.
.#.....#...#...#...#...#...#.#.#.#.....#.....#...#.....#...
.###################.#.###.###.#.#.###.#.#############.#.##
S#...................#.........#.....#.................#...