...#.....#.............#...#.............#.....#.......................#.............#............G
##.#.###.#.#######.###.###.#.#####.#####.#.#.###.#########.###########.#########.###.#.###########.
.#.#...#...#...#...#.#...#.......#...#.#.#.#...#...#.....#...#.......#...........#.#.#.....#...#...
.#.###.#####.#.#.###.###.#######.###.#.#.#####.###.#.#.#####.###.#.###############.#.#.###.#.#.#.##
...#.....#...#.#.#.....#...#...#...#.#.....#...#...#.#.#...#...#.#...#.......#.....#.#...#.#.#.....
.#####.###.###.#.###.#####.#.#.###.#.#####.#.#.#.###.#.#.#.###.#.###.#.#####.#.###.#.###.#.#######.
.....#.#...#.#.#...#.....#.#.#...#.#...#.....#.#.#...#...#.#...#...#.......#...#...#.#.#.#.#...#...
####.###.###.#.###.#####.#.#.#.#.#.###.#######.#.###.#####.#.#####.###########.#.###.#.#.#.#.#.#.##
...#.....#.#...#...#.....#.#.#.#.#.#.#.......#.#...#.#.#...#...#.#.....#.....#.#...#.#...#.#.#.#...
.#.#######.#.###.###.#####.#.#.#.#.#.#######.#####.#.#.#.#####.#.###.###.###.#.###.#.#####.#.#.###.
.#.....#...#.....#...#.....#.#.#.#.....#...#.....#.#...#.....#.#.....#...#.#.#...#.#.#.....#.#.#...
####.###.#.#######.###.#######.#.#####.#.#####.###.#.#######.#.###.###.###.#.#####.#.#.###.#.#.####
.....#...#.............#.......#.....#.#.....#.....#.#.......#...#.#.#...#.#...#...#.#...#.#.#.....
.###.#.#####################.###.#####.#.###.#########.#####.###.#.#.###.#.###.#.###.#.#.###.#####.
.#...#.#.....#...............#...#.....#...#...........#.......#.#...#.#.#.......#...#.#...#.....#.
.###.#.#####.#.#.###.###########.#.#########.###.#####.#######.#.###.#.#.#######.#.#######.#.#####.
...#.#.....#...#...#.#.........#.#...#.....#.#.#.....#.#.....#.#...#...#.......#.#.......#...#.....
##.#######.#.#####.#.#.#######.#####.#.###.#.#.#####.###.###.#####.#######.###.#.#######.#####.###.
...#.......#.#.....#.#.#.....#.#...#.#.#.#.#.......#.#.....#.....#.......#.#...#...#...#...#...#...
.###.#########.#.#####.#####.#.#.#.#.#.#.#.#######.#.#.#######.#########.#.#.#######.#.###.#.###.##
.#...#.........#.#...#.....#.#...#.#...#.#.....#...#...#.....#.....#.....#.#.#.....#.#...#...#.#...
.#.#######.#.#####.#.#####.#.#####.#####.#####.#########.###.###.#.#.#######.#.###.#.#.#.#####.###.
.#.#.......#.#.....#.....#.#...#...#...#.....#.....#...#.#.#.#...#.#.......#.#...#.#.#.#...#.....#.
.#.#.#########.#######.###.#.###.#.#.#.#.###.#####.#.#.#.#.#.#.#######.###.#.#.###.#.#.###.#.###.#.
.#.#.........#.#.....#.#...#...#.#...#.#.#.#.....#.#.#...#.#.#.#.....#.#...#.#.#...#.#...#.#...#.#.
.#.#####.###.#.###.###.#.#####.#.#####.#.#.#####.#.#.#####.#.#.#.###.###.###.#.#.#.#.###.#####.#.#.
.#.....#...#...#...#...#...#...#.....#.#.......#.#.#.#.......#.#...#.....#...#.#.#.#.#.#.....#.#...
.#####.###.#####.#.#.#.###.#.#######.#.#######.#.#.#.#####.###.###.#######.###.#.#.#.#.#####.#.####
.....#.#.........#.#.#...#.#.#.....#.#.#.....#.#...#.#...#.#.....#...#.#.....#.#.#.#.#.....#.#.#...
.#.###.#.#########.#.###.#.#.#.###.#.#.#####.#.#####.#.#.#.###.#.###.#.#.###.#.#.#.#.#####.#.#.###.
.#.#...#.#...#...#.#.#...#...#.#.....#.#...#.#.#.#...#.#.#.....#.#.#.#...#.#...#.#.#.......#...#...
##.#.###.#.#.#.#.###.#.#####.#.#######.#.#.#.#.#.#.#.#.#.#######.#.#.###.#.#####.#########.#####.#.
...#.#.#.#.#...#.#...#.....#.#.....#.....#.#.#.#...#...#.#...#...#.#...#.#...#.#...#.....#.....#.#.
.###.#.#.#.#####.#.#########.#####.#######.#.#.#.#######.#.###.###.###.#.#.#.#.###.#.###.#####.#.##
.#...#...#.....#.#...#.......#...#...#.......#.#...#...#.#...........#.#...#.....#...#.#.....#.#...
.#.###########.#.###.#.#######.#.###.#.#######.###.###.#.###.#########.#########.#####.#####.#.###.
...#.........#.#.....#.#.......#.....#.....#...#...#...#...#.#...#...#.#.#.......#.........#.#...#.
.#####.#####.#.#####.#.#.#############.#####.###.###.#####.###.#.#.#.#.#.#.#######.#######.#.###.#.
.#.....#.....#.....#.#.#.........#...#.#...#...#.....#.....#...#...#...#...#...#.#...#...#.#...#...
.###.###.#####.###.#.#.#########.#.#.#.#.#.###.#.#####.###.#.###########.###.#.#.###.###.#.###.###.
...#.#...#.......#.#.#...#...#.#...#.#.#.#.....#.#...#...#.#...#.......#.#...#.....#.....#...#.....
##.#.###.#######.#.#####.#.#.#.#####.#.#.#########.#.###.#####.#.###.###.###.###########.#.########
.#.#...#.......#.#.#.......#...#...#.#.#.#.........#.....#...#.#...#.#...#...#...........#.......#.
.#.#.#.#######.###.#.#########.#.#.#.###.###.#.###########.#.#.#.#.#.#.###.###.#####.#########.#.#.
...#.#...#.......#...#.....#.#.#.#.#...#...#.#.#.........#.#...#.#.#.#.#.#...#.#...#.........#.#.#.
.###.###.#######.#####.###.#.#.#.#.###.###.#.###.#######.#.#######.#.#.#.#.#.#.#.#.###########.#.#.
.#...#.#.....#.#.......#.#.#...#.#...#.......#...#.#...#.#.#.....#.#.#.#...#...#.#.#.......#...#.#.
.#.###.#####.#.#########.#.#.###.###.#########.###.#.#.#.#.#.###.#.#.#.#######.#.#.#.#####.#.###.#.
.#...#...#...#...........#.#...#...#.....#.....#...#.#.#...#...#...#.#...#...#.#.#...#.#...#.#.....
.###.#.#.#.###.#######.#.#.###.#####.#####.#######.#.#.#######.#####.###.#.#.###.#####.#.###.#####.
...#.#.#.#.#...#.......#.#...#.....#...#...#.......#.#.........#.#.....#...#.#...#.#.....#.....#...
##.#.#.#.#.#####.#######.###.#####.###.#.###.#######.#.#########.#.#########.#.###.#.#########.####
...#...#.#...#...#.....#...#.#...#.....#...#...#.....#...#.......#.#.#.......#...#...#.#.....#.#...
.###########.#.###.###.#.###.#.#.#########.###.#.#######.#.###.#.#.#.#.#######.#.#.###.#.#.#.#.#.#.
...#.......#.#...#.#.#.#.#...#.#...#.......#...#.#...#...#...#.#.#...#...#...#.#.#...#...#.#.#...#.
##.#.#####.#.#.#.#.#.#.###.###.###.#.#######.###.#.#.#.#######.###.#####.#.#.#.#.###.#####.#.#####.
.#...#.....#.#.#.#...#.....#.....#.#.....#.#.....#.#.#.......#.....#...#.#.#...#.#.#...#...#.....#.
.#####.#####.#.#.###.#######.###.#.#.###.#.#.#####.#######.#.#######.#.#.#.#####.#.###.#.#######.#.
.......#.....#.#...#.......#.#...#.#.#...#.#...#...#.....#.#.#.......#...#.#.#...#...#.#...#.......
.#########.#####.#.#######.###.###.###.###.###.#.###.###.###.#.###########.#.#.###.###.#.#.#######.
.....#.....#.....#.#.....#.#...#.#...#.#.........#...#.......#.#.........#...#...#.....#.#.....#...
####.#.#####.#####.###.#.#.#.###.###.#.#.#########.#.#######.#.#.#######.###.###.#.#########.#.#.##
.....#.....#.#...#.....#.#.#...#...#.#.#...#.......#.#...#...#...#.#...#...#...#.#.#.......#.#.#...
.#########.#.###.###.#####.#.#.#.#.#.#.###.#.#####.###.#.#.#######.#.#.###.###.#.#.###.###.###.####
...........#...#...#.#.....#.#.#.#.#...#...#.#.#...#...#.#.......#.#.#...#...#.#.#...#.#.....#.....
############.#.###.#.#.#######.#.#.#####.###.#.#.###.###.#######.#.#.###.###.#.#.###.#.#####.#####.
...........#.#...#...#.....#...#.#.......#...#...#...#...#.....#...#.#.#...#.#.#.#.#.#.....#.......
.###.#######.###.#########.#.#######.#####.#.#####.###.###.###.###.#.#.###.#.#.#.#.#.#####.#######.
...#.#.......#.#.....#.....#.#.....#.#.#...#.#...#...#.#...#.#...#.#.#...#...#.#.#.#.....#.#.#...#.
##.###.#######.#####.#.#####.#.###.#.#.#.#####.#.#.###.#.###.###.#.#.#.#.#######.#.#####.#.#.#.#.#.
...#...#.........#.#.#.#...#.....#.#...#.......#.#.#...#.#.....#.#.#.#.#.#.......#...#...#.#...#...
.#.#.###.#####.#.#.#.#.###.#.#####.###.#########.#.#.###.#.###.#.#.#.#.#.#.#######.#.#.###.###.####
.#.#...#.#.#...#...#...#...#.#...#.#...........#...#.....#.#...#.#.#...#...#.#.....#...#.....#.#...
.#####.#.#.#.###########.###.#.#.#.#######.#########.#####.#.###.#.#########.#.#############.#.#.#.
.....#.#...#.............#...#.#...#.....#.#.......#.......#.#...#...........#.....#.........#...#.
.###.#.#####.#####.#####.#.###.#####.###.###.#####.###.#####.#.###########.#######.#.#############.
.#...#.....#.....#.#...#.#...#.......#.#...#.....#...#.#...#.#.........#.#.#.......#.#...#.......#.
.#.#######.#####.#.#.#.#####.#########.###.#####.###.###.#.#########.#.#.#.#.#######.#.#.#.#####.#.
.#.........#...#.#...#.....#...#...#.....#...#...#...#...#.#.......#.#.#...#.......#.#.#.#.#...#.#.
.#############.#.#######.#.###.#.#.#.#######.#.#####.#.###.#.#####.#.#.#.#########.#.#.#.#.###.#.#.
.......#.....#...#.....#.#.#.#...#.#.......#.#.....#...#.#...#.....#.#.#...#.....#.#.#.#.#.#...#.#.
######.#.###.#.#####.###.#.#.#####.#####.###.#.###.#####.#####.#######.###.#####.#.#.#.#.#.#.###.#.
.....#...#.#.#.......#...#.......#.#...#.#...#...#...#.......#.#.......#...#.....#.#...#.#...#...#.
.#.#.#####.#.#######.#.###.#######.#.#.#.#.#####.###.#.#.#.###.#####.###.###.#.###.#.###.#.###.###.
.#.#.#.......#...#...#.#...#.......#.#.#.#...#.....#.#.#.#.#.........#.......#.#...#.#.#...#...#...
.#.#.#.#######.###.###.#####.#######.#.#.###.#.#####.###.###.#########.#######.#.###.#.#####.###.##
.#.#.#.#...#.......#.#.......#...#...#.#...#.#.#.#...#...#...#...#.......#...#.#.#.#.#.....#.#.#.#.
##.###.#.###.#######.###########.#.#.#.#.#.#.#.#.#.###.###.###.#.#.#######.#.###.#.#.#.###.#.#.#.#.
...#...#.....#.................#...#.#...#.#.#.#.#.#...#...#...#.#.#.......#.#...#...#...#.#.#.#...
.#.#.#######.###.#############.#####.#.#####.#.#.#.#.###.###.###.###.#######.#.###.#####.###.#.###.
.#.#.......#.#...#.......#...#.......#.#...#.#...#.#.....#...#.#...#.#.....#...#.........#...#.....
.#########.#.#.#######.#.#.#.###.#######.#.#.#####.#.#####.###.###.#.###.#.#####.#########.###.####
.#.......#.#.#.#.......#.#.#.....#.....#.#...#.....#.#.....#...#...#.....#.#.....#.......#.#.#.#...
.#.#####.#.#.#.#.#.#######.#######.###.#.#####.###.###.#######.#.#.#######.#.#####.#####.#.#.#.#.#.
.....#...#.#...#.#.#.........#.....#...#...#.....#.#...#.......#.#.#.....#.#.#.....#...#.#.#.#.#.#.
.#####.#.#.#####.###.#########.#####.#####.#.###.###.###.#####.#.#.#.#####.#.#.#####.###.#.#.#.###.
...#...#.#.#...........#.......#...#.#...#.#...#...#.....#.....#.#...#.....#.#.#.....#...#.#.#.....
##.#.#####.#############.#######.#.#.#.#.#.###.###.#######.#####.#####.#######.#.#####.###.#.#####.
S..#.....................#.......#.....#...#.....#.............#...............#...........#.......